元德	于占元	师生
毛毛	王金龙	夫妻
始平公主	晋惠帝	父母
王学兵	范冰冰	情侣
赵梓淇	周永恒	夫妻
洪一峰	陈爱玲	夫妻
王令尘	王靖雄	父母
李世民	李元吉	兄弟姐妹
蔡文姬	董祀	夫妻
大卫·欧伊斯特拉赫	伊戈尔·奥伊斯特拉赫	父母
何超云	何鸿燊	父母
段誉	王夫人	父母
陈垣	黄现璠	师生
谢东	戴娆	情侣
佟大为	关悦	夫妻
朱九真	朱长龄	父母
毛泽东	李敏	父母
杨子	杨祖武	父母
马丽娟	赵本山	夫妻
敖犬	棒棒堂	合作
冯金芙	冯志孝	亲戚
陈金霞	魏东	合作
梁元帝	萧衍	父母
冯子洋	冯玉萍	师生
徐帆	冯小刚	夫妻
张长青	郭德纲	好友
雒芊芊	雒启珂	父母
乔冠华	乔松都	父母
陈意涵	周渝民	情侣
张文霞	田立禾	夫妻
詹姆斯	科比	合作
安倍晋三	安倍晋太郎	父母
吴建豪	姚凤凤	兄弟姐妹
毛泽覃	贺子珍	兄弟姐妹
沈钧儒	范长江	父母
兰德里	马库斯·兰德里	兄弟姐妹
叶明勋	严停云	夫妻
刘仲容	赵祥锭	夫妻
谭小培	谭富英	父母
李宗盛	林忆莲	夫妻
于若木	陈元	父母
郑洁	彭帅	合作
高盛麟	茹富兰	师生
马克坚	景岗山	父母
吴阶平	吴蔚然	兄弟姐妹
吉恩	朱棣文	夫妻
许彩金	陈四	师生
梁思成	林洙	夫妻
郑芝龙	郑芝豹	兄弟姐妹
牛群	常宝华	师生
乔宗淮	乔冠华	父母
徐天红	尹小芳	合作
宋庆龄	宋美龄	兄弟姐妹
于魁智	何金海	师生
龙榆生	朱祖谋	师生
卢汉	龙泽清	夫妻
王俪桥	李嘉诚	父母
甄珍	刘家昌	夫妻
吉赛尔·邦辰	莱昂纳多·迪卡普里奥	情侣
刘培善	左英	夫妻
李明博	金润玉	夫妻
石晓亮	郭元祥	师生
全公主	孙鲁育	兄弟姐妹
霍震宇	霍震寰	兄弟姐妹
谭咏麟	朱咏婷	夫妻
梁天	梁晓天	父母
卡斯特罗	娜塔莉亚·雷韦尔塔	夫妻
段正淳	秦红棉	情侣
王耀武	王志兴	父母
张镇芳	袁世凯	兄弟姐妹
崔建邦	唐诗咏	情侣
林峰	林梦飞	祖孙
袁小海	袁世海	父母
尉迟恭	刘武周	上下级
田壮壮	陈凯歌	同门
伊瓜因	卢西亚娜	情侣
陈延年	陈独秀	父母
嵇璜	嵇永仁	祖孙
尉迟恭	长孙无忌	合作
白居易	白季庚	父母
端木蕻良	萧红	夫妻
张寿臣	张诚甫	父母
马塞洛·里皮	西蒙内塔·里皮	夫妻
袁保恒	袁保中	兄弟姐妹
折太君	杨业	夫妻
石原慎太郎	石原延启	父母
曹据	环夫人	父母
李万春	李永利	父母
李吉瑞	黄月山	师生
张孝若	张謇	父母
凤凰女	紫兰女	师生
何东	何锦姿	父母
李邈	李邵	兄弟姐妹
周永恒	赵梓淇	夫妻
范曾	边宝华	夫妻
梁赞	梁春	父母
白崇禧	白志书	父母
夏侯尚	夏侯儒	兄弟姐妹
黄铁良	佟守本	合作
吴竹似	刘正华	好友
赵昆	赵明生	亲戚
何爱榆	李小龙	父母
杨景辉	杨定富	父母
张瑞芳	余克稷	夫妻
朱德	贺治华	夫妻
吕婉柔	汪小菲	情侣
聂荣臻	张瑞华	夫妻
毛新宇	邵华	父母
王皓	彭陆洋	情侣
傅全香	陆梅英	师生
爱因斯坦	爱尔莎	夫妻
索罗斯	多美子·博尔顿	夫妻
慕容垂	慕容俊	兄弟姐妹
吴小楼	袁雪芬	合作
闻一多	高孝贞	夫妻
刘威	杨若兮	情侣
粟裕	楚青	夫妻
左塞尔	伊内特卡伊丝	父母
李兆基	徐子淇	父母
曹昂	曹操	父母
李孝贞	金旼贞	合作
吴慈美	林志玲	父母
侯军	侯宝林	祖孙
周慧江	厉慧兰	夫妻
孙道存	颜宁	情侣
贾母	贾宝玉	祖孙
潘玉良	潘赞化	夫妻
孙连仲	宋哲元	亲戚
孙和	孙皓	父母
丁光生	竺可桢	亲戚
包拯	包繶	父母
周晓平	周有光	父母
梁邦楚	张书旗	师生
钟镇涛	钟懿	父母
阿尔法	顾嘉铭	合作
谭正岩	谭富英	祖孙
孙海英	吕丽萍	夫妻
彭帅	谢淑薇	合作
萧楷成	司徒慧聪	师生
孔伯华	孔令谦	祖孙
路飞	乌索普	合作
李敏	毛泽东	父母
杨少彭	杨乃彭	父母
雷振春	雷喜福	父母
托马斯·斯塔福德	尤金·塞尔南	合作
姚贝娜	姚峰	父母
傅恒	孝贤纯皇后	兄弟姐妹
毛甜懿	毛东东	兄弟姐妹
金敬姬	张金松	父母
宫崎骏	宫崎吾朗	父母
范玮琪	陈建州	夫妻
张学良	于凤至	夫妻
郭守正	郭台铭	父母
郑经	郑成功	父母
李霄鹏	李媛	夫妻
罗达伦	罗伯健	父母
孙策	孙绍	父母
汪野亭	汪少平	父母
哪吒	李靖	父母
林心如	唐季礼	情侣
蔡元培	黄仲玉	夫妻
张正芬	伊能静	父母
廖承志	廖凤舒	亲戚
邓愈	邓顺兴	父母
邱创成	勇	夫妻
张克群	高立人	夫妻
刘濞	刘邦	亲戚
梅兰芳	王瑶卿	师生
曹操	曹彰	父母
黄铁良	侯宝林	师生
蒋友常	蒋友柏	兄弟姐妹
张彩苑	河莉秀	好友
岸边成雄	田边尚雄	师生
欧阳奋强	康丽	夫妻
冯友兰	冯台异	父母
罗福山	罗小奎	祖孙
流川枫	古式	父母
陈丽达	陈强	父母
谢贤	狄波拉	夫妻
蔡依林	周杰伦	情侣
陈娟红	高旗	夫妻
火亮	钟少珍	师生
撒贝宁	章子怡	情侣
罗章龙	邓中夏	好友
李家诚	徐子淇	夫妻
李天一	梦鸽	父母
徐宗汉	徐慕兰	兄弟姐妹
孔琳	耿乐	情侣
爱新觉罗·胤禄	康熙	父母
陈冠希	赵晨浩	好友
王鸿寿	李洪春	师生
宋霭龄	宋庆龄	兄弟姐妹
邢峰	朱慧珍	情侣
中森明菜	中森明穗	兄弟姐妹
杨载福	光绪	上下级
甄子丹	甄济如	父母
罗世忠	李伯清	同门
杨秀清	冯云山	兄弟姐妹
王璐瑶	王戈情	父母
田力行	何念慈	夫妻
唐美云	唐冰森	父母
萧楷成	刘育三	师生
陈宝仪	罗乐林	夫妻
曹上	曹彪	兄弟姐妹
王子腾	王熙凤	父母
林长民	梁启超	亲戚
朱元璋	朱标	父母
武松	武大郎	兄弟姐妹
张玉林	张桂庭	祖孙
张居正	张允修	父母
张菲	张少怀	父母
赵晨浩	林建岳	好友
小香玉	王小芬	合作
范志毅	李倩	夫妻
诺罗敦·诺林达拉邦王子	诺罗敦·西哈莫尼国王	父母
宋蔼龄	宋美龄	兄弟姐妹
范霞	王学圻	父母
黎婴	黎民伟	祖孙
王重阳	谭处端	师生
江上青	王者兰	夫妻
高力士	冯盎	祖孙
爱新觉罗·永瑆	爱新觉罗·永琪	兄弟姐妹
董璇	高云翔	情侣
夏时济	夏明翰	祖孙
李师师	周邦彦	夫妻
方静	阿忆	合作
德维恩·韦德	奥尼尔	合作
吕雉	吕台	亲戚
丹朱	尧帝	父母
刘宗杨	刘砚芳	父母
郭炳江	郭炳联	兄弟姐妹
袁枚	乾隆	上下级
丁晓兵	陶婉珠	夫妻
范志毅	徐根宝	师生
夏侯渊	夏侯霸	父母
孙鲁班	孙和	兄弟姐妹
唐寅	沈周	师生
徐若瑄	冯德伦	情侣
文亮臣	罗福山	师生
柯南	吉田步美	好友
袁雪芬	鲍金龙	师生
叶步青	叶问	师生
吴淑珍	陈致中	父母
高晓松	徐珊珊	夫妻
金正日	洪一天	夫妻
李志民	刘平	夫妻
王政君	王禁	父母
小映霞	王文川	师生
薄熙莹	薄熙永	兄弟姐妹
上官婉儿	上官仪	祖孙
秦沛	姜文杰	父母
林则徐	林鸣鹤	兄弟姐妹
伍文忠	梁文博	师生
薛君度	黄德华	夫妻
宋江	花荣	好友
罗百岁	马增寿	师生
陈锦鸿	杜雯惠	夫妻
刘恒林	杨小萍	夫妻
巴尔德斯	普约尔	合作
李承鹏	黄健翔	好友
杨受成	杨诺思	父母
孙策	陆抗	祖孙
管笑笑	杜勤兰	父母
曹休	曹肇	父母
萨科齐	皮埃尔·萨科齐	父母
何香凝	孙中山	合作
贺龙	贺鹏飞	父母
凤飞飞	赵宏琦	夫妻
梅加瓦蒂	父	父母
阎揆要	徐向前	合作
慕容博	王语嫣	亲戚
徐熙娣	徐熙媛	兄弟姐妹
史可	黄小茂	夫妻
伍迪·艾伦	米亚·法萝	情侣
黄子珈	朴树	情侣
郭靖	耶律齐	父母
林徽音	林长民	父母
宗璞	冯钟芸	兄弟姐妹
邓卓翔	曲波	合作
陈羽凡	白雪	夫妻
方志敏	方英	父母
张光宇	叶浅予	好友
福康安	傅恒	父母
肯德里克·帕金斯	内特·罗宾逊	合作
曹爽	曹训	兄弟姐妹
金平日	金顺锦	夫妻
袁承志	穆人清	师生
金珠	巩天阔	父母
筱桂琴	丁果仙	合作
石原慎太郎	石原裕次郎	兄弟姐妹
张池明	明	夫妻
何超琼	蓝琼缨	父母
陈照奎	陈小旺	亲戚
蒋雯丽	顾长卫	夫妻
叶群	林立果	父母
吴建豪	Arissa	情侣
范松年	周德敷	师生
卡扎菲	赛义夫·阿拉伯·卡扎菲	父母
凯特·温斯莱特	路易斯·杜勒	情侣
孙维世	任锐	父母
张乐怡	张谋之	父母
荀攸	荀缉	父母
曹操	曹昂	父母
黄遵宪	光绪	上下级
赛金花	曹承玺	父母
单廷	林冲	合作
戴安娜王妃	詹姆斯·休伊特	情侣
王老赏	周兆明	师生
赵如兰	卞学鐄	夫妻
顾顺章	张国焘	好友
张道藩	蒋碧微	情侣
曾启荣	曾志伟	父母
黎姿	黎柱	父母
桑振君	常俊丽	师生
顾毓琇	顾慰连	父母
丁敏君	灭绝师太	师生
赖俊健	赖真真	兄弟姐妹
谭鑫培	王又宸	父母
李嘉欣	李嘉明	兄弟姐妹
石慧儒	荣剑尘	师生
罗章龙	黄现璠	同门
陈格	杜宪	父母
曹腾	曹嵩	父母
康子林	唐广体	合作
乐珈彤	琼瑶	师生
梁实秋	梁文茜	父母
郁达夫	何丽有	夫妻
姜桂题	雷彦	亲戚
叶开沅	钱伟长	师生
谭世秀	谭鑫培	祖孙
张韶轩	张韶涵	兄弟姐妹
杨过	欧阳锋	父母
张智霖	张慕童	父母
李炳辰	刘德华	师生
李可染	苏少卿	父母
丛兆桓	丛珊	父母
魏玩	魏泰	兄弟姐妹
陈富杰	黄芳	夫妻
扬雄	严君平	师生
姜宝林	姜宝兴	兄弟姐妹
罗玉凤	王云	父母
宋霭龄	孔祥熙	夫妻
俞菊笙	张二奎	师生
王子腾	王子胜	兄弟姐妹
姚名达	姚德源	祖孙
梁稳根	梁冶中	父母
维多利亚女王	维多利亚	父母
金日成	金圣爱	夫妻
蒋孝刚	王倚惠	夫妻
史万岁	史静	父母
樊粹庭	赵义庭	合作
舒马赫	拉尔夫·舒马赫	兄弟姐妹
杨尚昆	李伯钊	夫妻
林黛	冯宝宝	父母
冯巩	笑林	同门
张继青	沈丰英	师生
兰多夫	达柳斯-迈尔斯	合作
刘诗昆	叶向真	夫妻
粟裕	粟戎生	父母
尤彩云	陈聚林	师生
郝海东	孙继海	合作
沈嘉伟	邱淑贞	夫妻
戚雅仙	竺水招	合作
李豫	李遘	父母
胡小凤	张君秋	师生
张璇	常昊	夫妻
加藤繁	岸边成雄	师生
王应立	李慧来	师生
杨化然	杨少华	祖孙
高红岩	李树建	师生
孝圣宪皇后	凌柱	父母
荣海兰	荣宗敬	祖孙
田士杰	田荫亭	父母
安倍晋三	安倍昭惠	夫妻
何猷龙	何鸿燊	父母
李子君	李明珠	师生
塔拜	巴都海	父母
侯君集	李世民	上下级
曾馨莹	郭台铭	夫妻
加图索	莫尼卡	夫妻
徐冬梅	成龙	师生
蹇先任	蹇先超	兄弟姐妹
詹尼·范思哲	桑托·范思哲	兄弟姐妹
海顿	贝多芬	师生
高凤山	高德亮	师生
赵晨浩	蔡依林	情侣
郭襄	郭芙	兄弟姐妹
王明明	周思聪	师生
鸠山由纪夫	鸠山幸	夫妻
萧一山	李宗仁	好友
郭台强	罗玉珍	夫妻
小乔	大乔	兄弟姐妹
赵连喜	赵雅蓉	兄弟姐妹
刘仲	刘邦	兄弟姐妹
包玉刚	黄秀英	夫妻
陆小曼	吴曼华	父母
汉献帝	刘宏	父母
朴树	张亚东	好友
蒋介石	蒋经国	父母
孙尚香	孙权	兄弟姐妹
蔡万春	蔡万霖	兄弟姐妹
高德明	高闻元	父母
傅恒	李荣保	父母
劳德诺	陆大有	同门
刘伶	嵇康	好友
蒋经国	马英九	上下级
殷离	金花婆婆	师生
筱文滨	吴万达	师生
田不易	张小凡	师生
林晓峰	林珊珊	兄弟姐妹
李经文	杜近芳	师生
王威暘	王义夫	父母
蒋纬国	蒋孝刚	父母
田归农	南兰	情侣
杨智	刘晓婷	夫妻
魏梅照	张小巧	合作
贾谊	周勃	合作
谭咏麟	钟镇涛	合作
筱丹桂	冷山	情侣
加内特	奥·刘易斯·加内特	父母
吴绮莉	吴卓林	父母
曾江	焦姣	夫妻
柳真	李智勋	情侣
朱时茂	朱青阳	父母
夏姬	仪行父	情侣
康生	陈宜	夫妻
黎洪模	许宜扬	父母
贺锡敬	徐若瑄	情侣
郭守敬	刘秉忠	师生
孙法民	焦廷标	兄弟姐妹
郭泰源	张琼姿	夫妻
历小峰	葛姗姗	合作
耶律齐	郭靖	父母
王子文	王朔	情侣
许平君	刘询	夫妻
程潜	程熙	父母
李金泉	梅兰芳	合作
房祖名	大元	情侣
何顺信	张君秋	兄弟姐妹
范瑾	俞敏声	父母
袁世海	郝寿臣	师生
薛觉先	新少华	兄弟姐妹
范宝亭	刘奎官	师生
曹宪	曹操	父母
林毅夫	林火树	父母
谢阿蛮	高仙芝	情侣
萧克	萧星华	父母
孔继宁	毛泽东	祖孙
邹世龙	翁美玲	情侣
包伟铭	包小松	兄弟姐妹
何超盈	何鸿燊	父母
小渊优子	小渊惠三	父母
刘芸	聂远	情侣
明道	杨雅筑	情侣
曹操	曹宇	父母
张宇皎	眭禄	合作
杨盼盼	古寒	父母
元彪	元泰	合作
老舍	胡絜青	夫妻
吴瑞林	军	夫妻
曹永廉	姜依兰	夫妻
新凤霞	吴祖光	夫妻
谭孝曾	谭富英	祖孙
陈鸣志	邓继增	同门
小泉纯一郎	小泉正也	兄弟姐妹
朱仲丽	朱剑凡	父母
何汉斌	何汉青	兄弟姐妹
玛莎	五月天	合作
林博文	袁莉	夫妻
赵本山	高秀敏	合作
陈一冰	何雯娜	情侣
张闻天	刘英	夫妻
刘半农	刘天华	兄弟姐妹
福田康夫	福田达夫	父母
许德义	李寿安	父母
赵叔孺	赵佑宸	父母
孙治强	孙国元	父母
邓丽欣	方力申	情侣
黄希庭	张庆林	合作
白雪仙	陆飞鸿	合作
李嘉欣	刘銮雄	情侣
李亨	李佖	父母
迟喜珠	迟寿生	父母
解宝	解珍	兄弟姐妹
高百岁	周信芳	师生
蒋经国	蒋孝严	父母
刘育熙	刘北茂	父母
张洪沅	谢明山	合作
严复	严璩	父母
潘庸秉	潘陶宇	亲戚
袁尚	袁绍	父母
阎锡山	阎志敏	父母
王夫人	贾母	父母
石舫亘	蒋孝严	父母
关羽	关平	父母
吴晗	吴瑸珏	父母
周作人	刘半农	好友
袁和平	李连杰	合作
赵忠尧	萨本栋	合作
王庚	梁启超	师生
刘谦	文沛然	师生
关羽	黄忠	合作
勃列日涅夫	勃列日涅娃	父母
梧桐妹	贾静雯	父母
乌兰夫	云亭	夫妻
郭荣起	马德禄	师生
孙眉	陈粹芬	兄弟姐妹
柳湘莲	尤三姐	情侣
兰陵王	渔阳王高绍信	兄弟姐妹
郝明莉	郝德望	父母
李世民	李建成	兄弟姐妹
田中直纪	田中角荣	父母
廖仲恺	廖凤舒	兄弟姐妹
慕容盛	李旱	好友
于佳卉	江国宾	夫妻
郑九万	郑奇猛	父母
濮存昕	濮方	父母
小香玉	李易祥	合作
蔡葆真	邓颖超	同门
苏少卿	孟小冬	师生
陈正薇	陈大悲	父母
桓温	桓玄	父母
裘盛戎	裘桂仙	父母
叶准	叶正	兄弟姐妹
侯跃文	袁茵	夫妻
宋耀如	温秉忠	兄弟姐妹
孙维世	邓颖超	父母
陈发科	陈照旭	父母
牛得草	金不换	师生
珍妮·巴斯	菲尔·杰克逊	夫妻
车永宏	郭云深	同门
时青山	时小福	祖孙
张默	邓婕	父母
夏明震	曾志	夫妻
蒋中正	蒋经国	父母
蒋经国	俞扬和	父母
曾江	王馨平	亲戚
Selina	Hebe	合作
戴志诚	袁茵	夫妻
张菲	费玉清	兄弟姐妹
王晨	钱小芊	合作
邱羿霖	孙道存	情侣
徐艳琴	毛兰花	合作
贾惜春	贾珍	兄弟姐妹
谭嗣同	杨锐	合作
王美怡	王馨平	兄弟姐妹
秦昭襄王	雍	兄弟姐妹
关心焉	容星桥	兄弟姐妹
侯世宏	侯郭纯美	夫妻
姬云飞	关凌	情侣
尼克松	朱莉·尼克松	父母
张培刚	谭慧	夫妻
奥尼尔	Toney	父母
李多奎	王晓临	师生
郭龄瑞	郭台铭	父母
傅幸文	戚雅仙	父母
连战	方瑀	夫妻
巧姐	贾母	祖孙
尹桂芳	尹小芳	师生
蔡依珊	连战	父母
蒲松龄	刘氏	夫妻
董仲舒	司马迁	师生
英千里	蔡葆真	夫妻
朱文英	阎岚秋	父母
周家蔚	洪金宝	父母
程庭华	董海川	师生
陈祖德	陈济成	祖孙
贾蓉	贾珍	父母
阿姆斯特朗	迈克尔·柯林斯	合作
伊达政宗	伊达辉宗	父母
梁兴初	任桂兰	夫妻
令狐冲	岳灵珊	同门
王熙凤	贾赦	父母
兰德里	布鲁克斯	合作
齐良末	齐白石	父母
蒋友柏	蒋孝勇	父母
蹇先任	贺捷生	父母
周伯宜	鲁迅	父母
杜如晦	李世民	上下级
宗庆后	宗馥莉	父母
黎民伟	黎北海	兄弟姐妹
徐慕兰	徐佩瑶	兄弟姐妹
路三宝	尚小云	师生
金庸	查传讷	父母
本杰明·哈里森	卡罗琳·拉维尼姬·斯科特	夫妻
王义夫	王威旸	父母
蒋经国	蒋孝勇	父母
林瑞阳	张庭	夫妻
雷英	孙荣蕙	师生
周启生	周吉	父母
谷开来	谷望宁	兄弟姐妹
林志玲	林繁男	父母
莎士比亚	安妮·哈瑟维	夫妻
织田信长	织田秀孝	兄弟姐妹
大S	陈建州	好友
朱棣文	朱汝瑾	父母
赵云	刘备	上下级
侯佩岑	周杰伦	情侣
王宠惠	王大闳	父母
李默然	龙潮	夫妻
金敬姬	金日成	父母
穆巴拉克	苏珊·穆巴拉克	夫妻
罗启仁	汪小莉	情侣
皮晓萌	皮黔生	父母
袁世凯	袁克轸	父母
刘彻	王娡	夫妻
徐静蕾	张亚东	情侣
袁涣	袁徽	兄弟姐妹
贺鹏飞	贺龙	父母
王耀武	王志盛	父母
杜月笙	沈月英	夫妻
周有光	周晓平	父母
周信芳	裘丽琳	夫妻
方敏仪	罗嘉良	夫妻
余秋雨	马兰	夫妻
林语堂	廖翠凤	夫妻
吴鉴泉	马海龙	祖孙
张美娟	王芝泉	师生
路飞	蒙奇·D·龙	父母
钱妙花	黄笑笑	合作
刘春爱	骆玉笙	师生
习仲勋	习远平	父母
张庆林	王权红	合作
林志玲	邱士楷	情侣
瞿秋白	王剑虹	夫妻
韩明淑	朴韩吉	父母
谢亚龙	谢天竞	父母
塔拜	额克亲	父母
李宗瑞	吴亚馨	情侣
张居正	张静修	父母
耿冰娃	耿华	父母
周天娜	李察·基尔	情侣
李昭	胡德平	父母
郭瑶瑶	张筱贤	师生
陆小曼	王庚	夫妻
王秋杨	张宝全	夫妻
邱会作	敏	夫妻
宋哲元	孙连仲	亲戚
谭正岩	谭孝曾	父母
徐天红	徐玉兰	合作
胡美仪	毛俊辉	夫妻
巧姐	王仁	亲戚
郑进一	高金素梅	情侣
韦小宝	韦春花	父母
张柏芝	戴碧芝	兄弟姐妹
孔东梅	毛泽东	祖孙
麦浚龙	戴庚玲	情侣
东条英机	东条辉雄	父母
余英时	钱穆	师生
尹志强	米雪	情侣
万连堂	王琦	师生
许世勋	许晋亨	父母
傅家俊	陈建莹	情侣
马文广	姚颖	夫妻
魏武帝	曹丕	父母
刘占胜	文玉香	夫妻
梁启超	梁思懿	父母
张琳	李小娜	师生
娄昭君	娄昭	兄弟姐妹
胡适	曹诚英	兄弟姐妹
杨受成	杨成	父母
刘据	汉武帝	父母
张杰鑫	王致久	师生
曹上	孙姬	父母
郭台铭	林淑如	夫妻
唐纳德·特朗普	Trump	父母
慕容涉归	慕容耐	兄弟姐妹
梁伯熙	陈肖霞	师生
周广	周淑英	兄弟姐妹
赵本山	黄晓娟	合作
方青卓	方青媛	兄弟姐妹
陈茹玉	何炳林	夫妻
裘盛戎	钳韵宏	师生
夏侯渊	夏侯氏	亲戚
谢天华	朱永棠	合作
唐高宗	长孙无忌	亲戚
岳不群	令狐冲	师生
刘海粟	张韵士	夫妻
徐根宝	王后军	合作
旷伏兆	许更生	夫妻
杨雅卉	杨小萍	兄弟姐妹
宋江	孔明	师生
西王母	玉皇大帝	夫妻
季老	李玉洁	上下级
张镇芳	刘静斋	父母
戴克林	戴克明	兄弟姐妹
李瀚章	李鸿章	兄弟姐妹
孙琳琳	王濛	合作
高芳先	高华柱	父母
甄士隐	香菱	父母
朱希祖	黄侃	同门
庞伟	庞彦宏	父母
敬一丹	王梓木	夫妻
汪雨	陈紫函	情侣
王熙凤	林黛玉	亲戚
李家杰	李家诚	兄弟姐妹
鸣人	波风水门	父母
毛利辉元	小早川隆景	亲戚
李维嘉	龙丹妮	好友
易建联	姚明	合作
刘莎莎	张树春	师生
陈国令	雷鸣球	情侣
潘玮柏	张韶涵	情侣
姚水娟	金荣水	师生
黄任中	陈宝莲	父母
陈怀皑	陈凯歌	父母
贝时璋	贝濂	父母
黄睿靓	吴东河	祖孙
张娜拉	朱虎声	父母
曹操	曹冲	父母
郭晋安	郭令山	父母
秋瑾	秋寿南	父母
梅巧玲	梅雨田	父母
李吉瑞	薛凤池	合作
严嵩	严世蕃	父母
陈彦衡	梅雨田	好友
郭守正	黄子容	夫妻
宋祖英	金铁霖	师生
尹喜地	尹明善	父母
吕大防	吕大钧	兄弟姐妹
皮尔洛	加图索	合作
高凌风	金友庄	夫妻
克劳馥	Jordan	父母
赵子琪	路金波	夫妻
朱桂芳	朱文英	父母
曹干	陈妾	父母
李砚秀	李万春	夫妻
董三毛	刘丹丹	合作
鲍春来	钟波	师生
文强	文明君	父母
谭咏麟	彭健新	合作
小林觉	木谷实	师生
曾布	曾巩	兄弟姐妹
米芾	米友仁	父母
刘兰芳	王岩	父母
朱文英	朱桂芳	父母
高敏	陈志刚	夫妻
王世臣	陈雨亭	师生
李丞责	李发文	父母
常宝华	侯耀华	师生
令狐冲	岳不群	师生
丰子恺	丰璜	父母
汉献帝	曹节	夫妻
曹华	曹操	父母
王朔	周迅	情侣
哪吒	太乙真人	师生
马大猷	叶企孙	师生
常振芳	张文广	师生
马增芬	马连登	父母
粟戎生	楚青	父母
尚慧敏	孙荣蕙	师生
白全福	刘学仁	师生
石田雨龙	井上织姬	好友
曾国藩	李鸿章	合作
何爱榆	李海泉	夫妻
文章	马伊琍	夫妻
班德贵	张杰尧	师生
郭台铭	郭龄瑞	父母
任剑辉	陈皮梅	合作
孙莹莹	李仕凡	情侣
大S	汪小菲	夫妻
太乙救苦天尊	九灵元圣	上下级
李辙	李李	父母
林建岳	林孝贤	父母
蒋梦婕	林申	情侣
张威廉	雷传洛	夫妻
朱玲玲	霍震霆	夫妻
白全福	杨志刚	师生
鲍蕾	陆毅	夫妻
廖仲恺	何香凝	夫妻
张宁	卢兰	合作
汤唯	田雨	情侣
宋嘉树	孙中山	父母
洪一峰	洪荣宏	父母
曹斯杰	郭晓玲	夫妻
关礼杰	关枫馨	父母
宋子良	宋美龄	兄弟姐妹
赛金花	洪钧	夫妻
荣文蔚	阮伟文	夫妻
沈世启	张克林	师生
邓在军	周尔均	夫妻
吴国兴	陆如	师生
李商隐	李嗣	父母
陈乔恩	夏于乔	好友
武丁	小乙	父母
诸葛亮	诸葛圭	父母
张克群	高晓松	父母
安志杰	谢婷婷	情侣
廖凤舒	廖梦醒	亲戚
袁保恒	袁甲三	父母
刘宝瑞	高元钧	合作
刘秋宏	张会	合作
迈克尔·杰克逊	Jackson	父母
戴月琴	新凤霞	师生
颛顼	昌意	父母
张小凡	陆雪琪	夫妻
龙榆生	龙赓言	父母
贾南风	郭槐	父母
周云帆	陈一舟	合作
李东华	爱丝·柏兰莎	夫妻
宣统	溥任	兄弟姐妹
张承中	Selina	情侣
高百岁	高盛麟	合作
蔡旻纹	蔡依林	兄弟姐妹
宋江	李逵	上下级
张咏梅	张生淮	亲戚
吕光	吕文和	亲戚
松隆子	松本幸四郎	父母
费英东	褚英	合作
卡尔·本茨	贝尔塔·本茨	夫妻
陈延年	陈乔年	兄弟姐妹
宇喜多秀家	羽柴秀吉	父母
林建岳	余宝珠	父母
刘銮雄	宝咏琴	夫妻
张伯苓	张锡祜	父母
钟丽淇	拿度	夫妻
岳以恩	岳红	父母
徐熙娣	许雅钧	夫妻
陶哲轩	威廉	父母
夏明震	夏明衡	兄弟姐妹
康广仁	康有为	兄弟姐妹
冯沅君	冯台异	父母
马晗	刘莹	合作
牟其中	夏宗琼	夫妻
林海峰	林国圭	父母
高庆奎	贾丽川	师生
车永宏	李洛能	师生
刘国梁	王瑾	夫妻
郑允浩	赵晨浩	好友
观世音菩萨	阿弥陀佛	师生
相小泉	相元坤	师生
马介璋	马鸿铭	父母
蒋友梅	蒋孝文	父母
章士钊	章锦	父母
田慧	梅葆玖	师生
帕克	邓肯	合作
罗姆尼	兰诺·罗姆尼	父母
王京阳	王兵	父母
何香凝	廖承志	父母
陈致中	黄百禄	父母
吕大临	吕大忠	兄弟姐妹
汉景帝	汉文帝	父母
梁小鸾	梅兰芳	师生
寒春	阳和平	父母
蔡就胜	蔡卓妍	父母
羽田孜	羽田雄一郎	父母
夫差	伯嚭	上下级
郑允浩	吴尊	好友
袁雪芬	陶琪	师生
托尼·帕克	托尼	父母
刘诗诗	吴奇隆	情侣
赵树海	赵又廷	父母
张小伟	赵咪咪	合作
朱塞佩·威尔第	卡罗·朱塞佩·威尔第	父母
井柏然	BOBO组合	合作
新艳秋	王瑶卿	师生
谭嗣同	谭继洵	父母
常昊	聂卫平	师生
爱德华一世	埃莉诺	夫妻
钟懿	钟镇涛	父母
彭发	彭顺	兄弟姐妹
冯巩	赵炎	同门
黎健图	徐静斐	父母
洪晃	章士钊	祖孙
卢武铉	权良淑	夫妻
帕瓦罗蒂	阿杜瓦	夫妻
王雪涛	陈半丁	师生
金敬姬	张成泽	夫妻
李德伦	罗忠榕	合作
陈清渊	邓学军	合作
丁宁	郭焱	合作
高庆奎	高盛麟	父母
叶少兰	许嘉宝	夫妻
吴祖光	吴霜	父母
贾丽川	胡喜禄	师生
张茵	张成飞	兄弟姐妹
金秀山	何桂山	师生
刘若英	钟小江	夫妻
沙孟海	沙耆	兄弟姐妹
郭守正	曹斯杰	兄弟姐妹
梁宗岱	甘少苏	夫妻
赵晨浩	郭德纲	好友
周好璐	周传瑛	祖孙
羊献容	刘曜	夫妻
王娡	汉景帝	夫妻
何猷佳	何鸿燊	父母
李娜	李盛鹏	父母
孙红雷	巩俐	情侣
曹斯杰	曹忆非	父母
赵盈	冯潇霆	夫妻
沈银河	池尚昱	夫妻
莫文骅	刘亚楼	合作
曹勤	孙姬	父母
皇甫谧	皇甫叔献	祖孙
马少良	马玉良	父母
耿乐	孔琳	情侣
甄妮	傅声	夫妻
宋耀如	孔祥熙	父母
徐艳琴	徐文德	夫妻
理查德·基尔	辛迪·克劳馥	夫妻
徐世昌	王雅茹	夫妻
张之洞	左宗棠	合作
韩卫民	乔利程	夫妻
王志文	徐帆	情侣
小林光一	小林太平	父母
韩彩英	崔东俊	夫妻
厉彦芝	罗福山	师生
彭加木	彭海	父母
林育南	林育英	兄弟姐妹
杨进明	郭德纲	同门
何雯娜	马军阳	师生
刘若英	五月天	好友
王盛德	王敏德	兄弟姐妹
邱士楷	邱弘茂	父母
李琳	李大双	情侣
满宠	荀彧	合作
钟欣桐	Twins	合作
李肖逸	高竣熙	同门
孔海珠	茅盾	亲戚
梁左	梁欢	兄弟姐妹
朱德群	林风眠	师生
杨不悔	张无忌	好友
张德福	齐建波	师生
长孙皇后	长孙晟	父母
敖幼祥	陈诺宣	师生
刘弥群	刘太行	兄弟姐妹
陶喆	林韦君	情侣
刘娥	刘通	父母
阿姆斯特朗	马克	父母
吕布	貂蝉	夫妻
李存义	程庭华	师生
霍去病	霍光	兄弟姐妹
荣格	叔本华	好友
景荣庆	陈富瑞	师生
洪荣宏	洪荣良	兄弟姐妹
陈凯歌	洪晃	夫妻
狄波拉	张柏芝	父母
刘备	刘封	父母
孙鲁育	孙权	父母
金日成	金正日	父母
万方	苏蓬	父母
吴玉章	徐特立	好友
方逸华	邵逸夫	夫妻
钱三强	钱思进	父母
倪海天	高盛麟	合作
郭彦均	蓝心湄	好友
张澜	张崿	父母
林丹	陈宏	合作
夏侯尚	夏侯玄	父母
骆家辉	李蒙	夫妻
罗兆辉	刘銮雄	好友
郑嘉颖	刘家昌	师生
许鹿希	邓稼先	夫妻
曹仁	曹纯	兄弟姐妹
曹二庚	郭春山	师生
唐老鸭	黛丝	情侣
闫光明	赵海燕	合作
毛岸青	毛新宇	父母
张琼姿	郭思瑜	父母
孙科	孙中山	父母
杨谨华	张怀秋	情侣
杨露禅	杨班侯	父母
姜文	刘晓庆	情侣
李砚秀	李淑媛	父母
王小宝	孙丽荣	夫妻
张惠春	张惠妹	兄弟姐妹
曹宇	曹奂	父母
林月云	邱嘉雄	情侣
雪妮	唐佳	夫妻
孙悟空	猪八戒	同门
李秉宪	宋慧乔	情侣
张克澄	陆士嘉	父母
刘振华	林钧晓	夫妻
霍英东	霍震宇	父母
许崇清	许崇济	兄弟姐妹
周柳萍	谢建丰	师生
赵本山	小沈阳	师生
金范	金贤重	好友
付洋	彭真	父母
唐肃宗	李僖	父母
李湘	王诗龄	父母
韦小宝	方怡	夫妻
张占阳	郭新成	师生
田鹏飞	田忠阳	父母
黄美芸	高锟	夫妻
靓元亨	周瑜利	师生
詹尼·范思哲	多纳泰拉·范思哲	兄弟姐妹
李淳风	袁天罡	合作
陈发科	陈耕耘	祖孙
章子怡	章子男	兄弟姐妹
石慧儒	华连仲	师生
廖烈文	廖烈武	兄弟姐妹
林徽因	梁再冰	父母
黄孟复	黄炎培	祖孙
程莉莎	程子珊	兄弟姐妹
乔冠华	章含之	夫妻
程小青	黄含章	夫妻
邓卓翔	郑智	合作
刘肥	刘仲	亲戚
吴竹似	吴敬琏	父母
倪瓒	蒋氏	夫妻
蒋孝章	俞扬和	夫妻
胡小凤	梅兰芳	师生
李浩天	李少春	父母
常宝堃	常宝华	兄弟姐妹
郭靖	洪七公	师生
王素君	常香玉	合作
林韦君	许绍洋	情侣
郑振铎	高君箴	夫妻
李途纯	金晓琳	夫妻
徐静斐	黎健图	父母
梅兰芳	福芝芳	夫妻
娇杏	贾雨村	夫妻
王朔	冯小刚	好友
冯培澜	王奇	夫妻
曹训	曹彦	兄弟姐妹
关云长	关平	父母
王葆仁	吴萱	夫妻
王力宏	张惠妹	情侣
马英九	马立安	祖孙
张正芳	耿巧云	师生
林海峰	林敏浩	父母
马清伟	薛芷伦	夫妻
祝允明	唐寅	好友
沈星培	陆昌立	师生
黄志玮	关颖	情侣
刘思齐	毛岸英	夫妻
袁和平	袁小田	父母
郭嵩焘	肃顺	上下级
姚鼐	方东树	师生
焦姣	黄宗迅	夫妻
吕瑞英	范瑞娟	合作
周海婴	车晓林	父母
金开芳	金文善	父母
张正芬	顾正秋	同门
鲁迅	鲁瑞	父母
王汉斌	彭佩云	夫妻
王楠	郭之腾	父母
五十岚麻朝	深田恭子	情侣
贾小七	赵本山	师生
伍文忠	丁俊晖	师生
梁赞	梁二娣	师生
于世德	李维信	合作
金敬姬	金正淑	父母
唐哀帝	唐昭宗	父母
李洛能	戴龙邦	师生
吴静钰	卢秀栋	师生
詹姆斯	韦德	合作
靓次伯	白驹荣	合作
林则徐	陈帙	父母
孙周	孙淳	兄弟姐妹
大兵	奇志	合作
袁世凯	袁克齐	父母
小钟	吴宗宪	合作
吕瑞英	金采风	合作
赵玉芳	葛淑珍	父母
马景涛	于莉	情侣
焦守云	焦裕禄	父母
许晴	刘波	夫妻
刘宝全	常旭久	师生
邱淑贞	沈嘉伟	夫妻
德克·诺维茨基	杰西卡·奥尔森	夫妻
许嘉凌	许慧欣	兄弟姐妹
曹徽	宋姬	父母
费玉清	张少怀	亲戚
立花道雪	立花訚千代	父母
南勇	南兴烈	父母
王海容	王季范	祖孙
王祥云	徐颖	父母
许冠文	郑洁英	夫妻
蔡葆真	蔡凤	兄弟姐妹
钱学森	蒋英	夫妻
范瑞娟	韩婷婷	师生
刘曜	刘熙	父母
夏侯渊	夏侯衡	父母
钱振荣	高继荣	师生
王楠	张怡宁	合作
长孙皇后	晋阳公主	父母
金汝贞	金正日	父母
蒋孝勇	蒋友柏	父母
宗馥莉	施幼珍	父母
服部平次	服部平藏	父母
曹仁	曹范	父母
程颐	吕大临	师生
王占元	段祺瑞	同门
杨南日	杨紫琼	兄弟姐妹
凯蒂·佩里	拉塞尔·布兰德	夫妻
小白玉霜	白玉霜	父母
陈群	陈泰	父母
李砚萍	李砚秀	兄弟姐妹
谢婷婷	谢霆锋	兄弟姐妹
谢侠逊	谢公佑	亲戚
叶德娴	刘德华	父母
麦嘉轩	麦法诚	父母
金大中	车容爱	夫妻
江姐	彭云	父母
刘永好	刘永行	兄弟姐妹
陈幸妤	吴淑珍	父母
郑裕彤	郑家纯	父母
杜琪峰	游乃海	合作
司马邺	司马晏	父母
俞明震	俞明观	兄弟姐妹
金正日	金惠敬	父母
夏姬	陈灵公	情侣
王烁	王艳	父母
刘仲	刘濞	父母
马大猷	萨本栋	师生
金万昌	张德海	师生
刘北茂	刘育熙	父母
威廉·迈巴赫	卡尔·迈巴赫	父母
康生	张子石	父母
刘聪	刘曜	兄弟姐妹
王德显	孙英杰	师生
周采茨	周信芳	父母
菲德尔·卡斯特罗	劳尔·卡斯特罗	兄弟姐妹
程颐	游酢	师生
犬养毅	芳泽谦吉	父母
高盛麟	程砚秋	合作
余隆	丁善德	祖孙
佟守本	赵世忠	合作
工藤静香	森高千里	好友
王诗龄	李湘	父母
帕克	托尼	父母
王个簃	吴昌硕	师生
范瑞娟	袁雪芬	合作
荣剑尘	金维源	师生
宋飞	宋国生	父母
郑克臧	郑经	父母
张菲	吴宗宪	好友
埃德加·斯诺	海伦·斯诺	夫妻
刘禅	甘夫人	父母
孙中山	蒋介石	兄弟姐妹
刘若英	张艾嘉	师生
梁赞	梁博俦	师生
司马绍	庾文君	夫妻
黎婴	黎姿	兄弟姐妹
秦海璐	秦子涵	兄弟姐妹
曾书书	陆雪琪	同门
顾长卫	蒋雯丽	夫妻
吉姆·洛威尔	杰克·斯威格特	合作
卡拉·布吕尼	阿尔贝托·布吕尼·蒂戴西	父母
叶露茜	杜宣	夫妻
霍去病	卫青	亲戚
关肃霜	李佩红	师生
汪诗诗	甄济嘉	父母
马英九	马乃西	兄弟姐妹
蒋介石	姚冶诚	夫妻
唐肃宗	李侹	父母
陈友仁	张静江	父母
邓楠	邓小平	父母
小小彬	小彬彬	父母
林如海	林黛玉	父母
杨小萍	杨雅卉	兄弟姐妹
希拉克	贝尔纳黛特·希拉克	夫妻
方子哥	颜珍	夫妻
翟波	傅贵山	师生
洪秀全	萧朝贵	上下级
傅锐	付洋	兄弟姐妹
容星桥	关心焉	兄弟姐妹
王金水	施银花	师生
张凯丽	可可	父母
吕庆欣	霍启刚	情侣
洪承畴	洪启熙	父母
关肃霜	梅兰芳	师生
孙皓	孙瑾	父母
袁和平	吴思远	师生
李名强	李祖彝	父母
金吒	哪吒	兄弟姐妹
廖仲恺	廖晖	祖孙
李富春	蔡和森	兄弟姐妹
穆铁柱	穆桐	父母
杨希	王新欣	夫妻
裘芸	张顺	师生
洪钧	张佩纶	好友
李赛凤	宗天意	父母
何大一	郭素玉	夫妻
魏梅照	徐玉兰	合作
鄢颇	梅婷	夫妻
何庆魁	高秀敏	夫妻
谢启美	章汉夫	兄弟姐妹
黄秀虹	黄燕虹	兄弟姐妹
叶志铭	叶崇仁	父母
林孝贤	钟欣桐	情侣
梅竹芬	杨隆寿	父母
彭长健	刘观英	夫妻
许亚军	何晴	夫妻
刘琮	蔡氏	夫妻
姚玉兰	姚玉英	兄弟姐妹
诸葛亮	诸葛均	兄弟姐妹
司马衍	司马绍	父母
陈毅	罗炳辉	合作
王承	王昶	祖孙
叶选廉	叶剑英	父母
黎兵	甘萍	夫妻
陈矫	陈骞	父母
郎朗	赵屏国	师生
傅娟	欧阳娜娜	父母
魏莲芳	梅兰芳	师生
马寅初	马仰曹	父母
曹干	王昭仪	父母
关公	关兴	父母
许玮伦	林依晨	好友
孙毓敏	李翔	同门
吴晗	袁震	夫妻
曹敏莉	张家杰	夫妻
濮方	濮存昕	父母
曾江	林翠	兄弟姐妹
魏春荣	李倩影	师生
张闾瑛	于凤至	父母
林百欣	谢玲玲	父母
袁小田	袁日初	父母
连胜文	蔡依珊	夫妻
陈燕琳	李彧	夫妻
李鸿章	张爱玲	祖孙
裘丽琳	周采茨	父母
陈独秀	潘兰珍	夫妻
李雪	李冰冰	兄弟姐妹
任继愈	冯钟芸	夫妻
杜如晦	侯君集	合作
刘禅	刘谌	父母
丰臣秀吉	织田信长	父母
苏岩	陶经	夫妻
赵景深	李小峰	兄弟姐妹
阿道夫·希特勒	爱娃·布劳恩	夫妻
火亮	胡燕	师生
赖亚文	陈忠和	合作
林韦君	林佑威	情侣
金万昌	韩万祥	师生
杨一清	杨景	父母
傅秋涛	叶挺	合作
大乔	小乔	兄弟姐妹
夏雨田	茅贵娴	夫妻
夏梦	林葆诚	夫妻
马诗慧	黄重生	夫妻
蔡依珊	蔡绿峰	父母
全公主	孙峻	情侣
郭嵩焘	咸丰帝	上下级
郭羡妮	温兆伦	情侣
马岳梁	吴英华	夫妻
李亚鹏	李嫣	父母
王敏德	张天爱	兄弟姐妹
蹇先任	蹇先佛	兄弟姐妹
浦熙修	浦通修	兄弟姐妹
蒋才如	刘艾琳	合作
李应生	徐宗汉	亲戚
袁绍	袁谭	父母
大枝雄介	前田阵尔	师生
丘成桐	陈省身	师生
杜鲁门	马莎·埃伦·扬·杜鲁门	父母
刘雪涛	赵燕侠	合作
郭台铭	郭台成	兄弟姐妹
陆锦娟	筱兰芳	合作
牛魔王	如意真仙	兄弟姐妹
徐庆平	徐悲鸿	父母
王刚	袁立	情侣
吴伯雄	吴鸿麒	亲戚
黄月山	李吉瑞	师生
赵忠尧	钱三强	师生
李韵秋	李永华	父母
郭德纲	金文声	师生
阎锡山	徐竹青	夫妻
赵薇	魏启颖	父母
张允和	张兆和	兄弟姐妹
薛艳君	张小兰	合作
徐德亮	郭德纲	合作
战福章	战殊	父母
服部平次	工藤新一	好友
贝克汉姆	克鲁兹·贝克汉姆	父母
赵兰坤	连横	父母
连战	连震东	父母
慕容廆	慕容涉归	父母
赵丽蓉	赵连喜	兄弟姐妹
陈德勋	罗小玲	夫妻
易心莹	吴君可	师生
龙云	林黛	父母
翁美玲	邹世龙	好友
秦叔宝	裴仁基	上下级
洪天明	洪煦榆	兄弟姐妹
周正毅	毛玉萍	情侣
刘天佐	方慧	夫妻
邓丽君	郭孔丞	情侣
卫青	刘据	亲戚
顾城	谢烨	夫妻
肯尼迪	约瑟夫·帕特里克·肯尼迪	父母
蒋兴权	巴特尔	师生
原田淑人	黄现璠	师生
吴佳尼	马世天	父母
森园美咲	石川佳纯	合作
慕容宝	慕容盛	父母
盘庚	阳甲	兄弟姐妹
葛优	葛存壮	父母
罗百岁	孙怡云	父母
郑小瑛	郑苏	父母
李顺圭	李秀满	亲戚
少女时代	金孝渊	合作
蒋碧薇	张道藩	情侣
潘金莲	武大郎	夫妻
陈宝珠	宫粉红	父母
曹禺	万方	父母
查尔斯王储	卡米拉	夫妻
道光	端顺固伦公主	夫妻
阿姆斯特朗	大卫·斯科特	合作
张克群	梁思成	师生
陈骞	陈矫	父母
江竹筠	彭咏梧	夫妻
葛树志	崔谨兰	夫妻
丁俊晖	丁文钧	父母
李赋京	李景英	父母
徐少强	徐伟栋	父母
梁左	范荣康	父母
罗倩文	张国立	夫妻
迈克尔-舒马赫	拉尔夫·舒马赫	兄弟姐妹
钱思进	钱三强	父母
华生	铁凝	夫妻
张子健	张志宽	父母
张承中	张世良	父母
梅兰芳	吴菱仙	师生
王恩茂	骆岚	夫妻
欧阳予	袁宁	夫妻
王愿坚	王愈坚	兄弟姐妹
王小波	王方名	父母
小泉进次郎	小泉纯一郎	父母
格瓦拉	伊尔达·加德亚	夫妻
费俊龙	聂海胜	合作
赵无极	贝聿铭	好友
鲍吉祥	马云樵	师生
林冲	宋江	上下级
孙鲁育	朱王妃	父母
魏春荣	林萍	师生
郑中基	杨千嬅	好友
周雅菲	莫科	夫妻
刘宝瑞	白云鹏	合作
杜月笙	孟小冬	夫妻
万方	曹禺	父母
马珏	陈德馨	父母
萧盛萱	萧长华	父母
杨过	穆念慈	父母
周苏红	汤淼	夫妻
李依琳	林珍奇	父母
张皇后	张麒	父母
张茵	刘名中	夫妻
李俊毅	李鸿禧	父母
梁天	梁欢	兄弟姐妹
贾母	邢夫人	父母
袁惟仁	陆元琪	夫妻
卡扎菲	阿伊莎·卡扎菲	父母
C罗	本泽马	合作
谢天顺	谢金	父母
彭顺	彭发	兄弟姐妹
张丹峰	洪欣	夫妻
慕容盛	兰汗	父母
邓世昌	邓焕庄	父母
廖镇汉	孙芸芸	夫妻
陈幸妤	赵翊廷	父母
王玉龄	张灵甫	夫妻
宋美龄	孔令侃	亲戚
福坪安	李鹤谦	师生
戚雅仙	王杭娟	师生
张芝华	查国钧	夫妻
史蒂夫·弗朗西斯	姚明	好友
刘曜	刘胤	父母
卡斯特罗	劳尔·卡斯特罗	兄弟姐妹
蒋孝刚	蒋友捷	父母
殷野王	殷离	父母
李嘉诚	李素娟	兄弟姐妹
丛珊	萧锋	夫妻
郭士强	郭艾伦	亲戚
韩增祥	毕谷云	合作
李敖	李文	父母
秦琼	李世民	上下级
王小波	王晨光	兄弟姐妹
洪天照	洪金宝	父母
袁克桓	陈启泰	父母
邬丽珠	任意之	父母
赵高	秦二世	上下级
马世啸	马富禄	亲戚
郑振铎	瞿秋白	好友
林淑如	郭台铭	夫妻
关心妍	杨长智	夫妻
许爱周	许士芬	父母
陈望道	张志让	合作
王又曾	王业恢	兄弟姐妹
吴奇隆	马雅舒	夫妻
孙鲁班	孙霸	兄弟姐妹
葛淑珍	赵铁蛋	父母
王治郅	姚明	合作
王玉蓉	陈巨来	同门
钟连鸣	叶福海	师生
何超贤	HO-KJAER	父母
黄现璠	郭沫若	同门
郭荣起	朱相臣	合作
谭家述	沈阳	夫妻
齐建波	张德福	师生
林晓峰	林海峰	兄弟姐妹
布鲁克斯	巴蒂尔	合作
王小利	小沈阳	同门
谭韵寿	谭元寿	兄弟姐妹
刘允斌	何葆贞	父母
牛魔王	红孩儿	父母
李四光	李林	父母
赵如兰	赵元任	父母
陈泰	陈温	父母
谢东	侯宝林	父母
罗鹰石	罗康瑞	父母
张爱玲	赖雅	夫妻
包玉刚	苏海文	父母
林峰	潘霜霜	情侣
陈毅	粟裕	亲戚
官晶华	郑咏恩	父母
清河长公主	曹昂	兄弟姐妹
张天爱	王敏德	亲戚
韩素音	唐柏	夫妻
郭破虏	郭靖	父母
韦小宝	双儿	夫妻
卓琳	邓小平	夫妻
雒芊芊	景涛	父母
陈宏	陈宏	合作
格瓦拉	卡斯特罗	合作
林志刚	邓亚萍	夫妻
陈凯歌	孙加林	夫妻
叶大鹰	叶挺	祖孙
孙和	孙德	父母
斯嘉丽·约翰逊	瑞恩·雷诺兹	夫妻
何超云	何超盈	兄弟姐妹
李维嘉	江璐	情侣
田佳	韩云波	师生
奥巴马	米歇尔·奥巴马	夫妻
焦跃进	焦裕禄	父母
马增蕙	马增芬	兄弟姐妹
韩金凯	濮方	夫妻
裘芸	裘盛戎	父母
周迅	宋宁	情侣
姜大卫	红薇	父母
高芳先	李先良	上下级
屠杏花	李艳芳	合作
郝兰田	龚云甫	师生
施银花	赵瑞花	合作
孙楠	买宝瑶	父母
高盛麟	王喜秀	师生
陈阿娇	陈须	兄弟姐妹
武敦儒	武三通	父母
高英姬	金正哲	父母
王希坚	王辩	兄弟姐妹
李宝櫆	梅兰芳	亲戚
猪八戒	沙僧	同门
黄圣依	周星驰	师生
苏少卿	李可染	父母
廖凤舒	廖仲恺	兄弟姐妹
刘连玉	金万昌	师生
周慰堂	周信芳	父母
黄品源	巫若萍	夫妻
梁静	管虎	夫妻
孙燕姿	孙燕佳	兄弟姐妹
黄家强	黄贯中	好友
徐淑敏	黄重生	情侣
吴小楼	陈琴香	师生
蒋孝章	俞大维	父母
花淑兰	潘洪伟	师生
白玉梅	屠杏花	合作
郭炳湘	邝肖卿	父母
马小曼	梅兰芳	父母
宋文治	宋玉麟	父母
梁思宁	章柯	夫妻
李度崘	李昌郁	父母
贾谊	汉文帝	上下级
张达明	何念慈	夫妻
杨丞琳	罗志祥	情侣
焦仁和	张悬	父母
齐秦	方伟	父母
曹冲	曹植	兄弟姐妹
伊迪丝·罗斯福	西奥多·罗斯福	夫妻
杉内雅男	杉内寿子	夫妻
祖冲之	戴法兴	合作
黎洪模	黎维玲	父母
霍震霆	霍启刚	父母
蔡元培	蔡威廉	父母
石小梅	张弘	夫妻
孙英杰	王德显	师生
黄志忠	何音	夫妻
李世民	长孙皇后	夫妻
张庆林	李红	合作
高凤山	侯宝林	合作
蒲宜君	蒲添生	祖孙
郭秀云	钱景峰	父母
李永波	谢颖	夫妻
刘索拉	瞿小松	夫妻
张大千	张善子	兄弟姐妹
马克莱莱	诺米尔·莱诺	情侣
徐艳琴	阎立品	合作
邓榕	贺彪	父母
吴毅将	唐丽球	夫妻
诸葛亮	刘备	上下级
茹绍荃	茹富兰	父母
秦汉	刘雪华	合作
范斌	姚明	合作
辽景宗	怀节萧氏	父母
赵剑英	覃献平	父母
杨红丽	张鸣琴	父母
戴立忍	桂纶镁	情侣
唐老鸭	米奇	好友
冯德伦	徐若瑄	情侣
钟少珍	李巧贤	师生
黎莉莉	潘婕	祖孙
郭荣启	谢天顺	师生
连战	连胜文	父母
曹锟	曹本生	父母
马泰	张润时	师生
连胜文	连惠心	兄弟姐妹
丘吉尔	克莱门蒂娜·霍齐尔	夫妻
孔亮	孔太公	父母
宋美龄	蒋介石	夫妻
魏文亮	李相友	师生
黄德斌	邵美琪	情侣
郭凯敏	刘晓春	夫妻
吴伯雄	吴鸿麟	父母
耿冰娃	朱桂芳	师生
王刚	张国立	好友
左小祖咒	贾樟柯	好友
傅钟	刘筱圃	夫妻
丰臣秀次	真田幸村	父母
荀彧	荀衍	兄弟姐妹
陈燕	肖智	夫妻
黄子扬	惠英红	情侣
马大猷	任之恭	师生
夏侯光姬	司马觐	夫妻
陈琦	徐涵英	合作
黄健华	焦家良	合作
梁思成	梁再冰	父母
袁克坚	袁伯祯	兄弟姐妹
徐根宝	胡志军	师生
周利	宋丹菊	师生
陈品颖	蔡淑媛	父母
陈及时	何东旭	同门
万籁鸣	万古蟾	兄弟姐妹
武田胜赖	武田信胜	父母
森喜朗	智慧子	夫妻
张苞	张飞	父母
陈毅	肖菊英	夫妻
丁光生	丁绪贤	父母
吕洋	王吟秋	师生
刘备	刘弘	父母
范伟	赵本山	好友
刘菁	许昱华	夫妻
郭沫若	郭世英	父母
彭德怀	彭荣华	兄弟姐妹
叶问	陈华顺	师生
王玉蓉	小王玉蓉	父母
权良淑	卢武铉	夫妻
曾昭娟	花淑兰	师生
沙奎尔·奥尼尔	韦德	合作
周渝民	吴建豪	合作
上海妹	半日安	夫妻
张栩	林海峰	师生
毛阿敏	解丰鸣	父母
谷超豪	胡和生	夫妻
周海水	崔兰田	师生
梁花侬	梁秀娟	父母
常香玉	蓝继策	好友
蔡加怡	蔡志明	父母
郑嘉颖	佘诗曼	情侣
路飞	弗兰奇	合作
傅小山	马富禄	师生
宗其香	周志龙	师生
哈利·波特	罗恩·韦斯莱	好友
薛艳君	赵登先	合作
邓殿奎	李文通	师生
杨威	黄玉斌	师生
黄炎培	黄大能	父母
赵登禹	赵学武	父母
伍文忠	田鹏飞	师生
蒋友柏	蒋友青	兄弟姐妹
何鸿燊	何超琼	父母
林彪	叶群	夫妻
罗巧福	梅巧玲	师生
张智霖	袁咏仪	夫妻
汤珈铖	汤子嘉	兄弟姐妹
李四光	邹承鲁	父母
周慧敏	倪震	夫妻
刘永言	刘永行	兄弟姐妹
小林光一	大矢浩一	师生
吴化文	马玉珍	夫妻
寇准	宋太宗	上下级
沉樱	梁思薇	父母
杨化然	刘国君	同门
张艾嘉	王令尘	父母
诸邑公主	汉武帝	父母
唐丽球	吴毅	夫妻
方展荣	吴玲儿	夫妻
卞兰	张银娣	师生
陈剑	张艺谋	兄弟姐妹
胡碧兰	侯喜瑞	合作
浦安修	浦通修	兄弟姐妹
马三立	刘奎珍	合作
叶问	叶正	父母
张申府	张崇年	兄弟姐妹
罗志祥	欧弟	合作
魏莲芳	王瑶卿	师生
邓肇坚	邓志昂	父母
黄宗江	黄宗英	兄弟姐妹
孙毓敏	方开柳	师生
李俐	满文军	夫妻
连胜武	连战	父母
何超云	陈山聪	情侣
钟鸣岐	裘盛戎	合作
李菁菁	张金华	夫妻
李林	李四光	父母
慕容垂	慕容皝	父母
蒋大为	张佩君	夫妻
蔡少芬	张晋	夫妻
杜笃之	杜均堂	父母
扬古利	太祖	父母
李佳薇	李超	夫妻
真田幸村	真田信幸	兄弟姐妹
克莱德·德雷克斯勒	巴克·威廉姆斯	合作
葛洪	葛玄	祖孙
李彩桦	王傲山	情侣
吕良伟	吕良国	兄弟姐妹
唐涤生	郑孟霞	夫妻
王烁	牛萌萌	情侣
犬夜叉	十六夜	父母
周汶锜	周丽淇	兄弟姐妹
王戎	王浑	父母
汪峰	章子怡	情侣
茹富蕙	茹富兰	兄弟姐妹
孙科	孙穗芳	父母
陈素真	樊粹庭	师生
周建人	周晔	父母
关颖	蔡万春	祖孙
牛得草	牛亚非艺名小牛得草	师生
葛优	冯小刚	好友
王力宏	许倬云	亲戚
郁达夫	王映霞	夫妻
夏侯渊	夏侯绩	祖孙
张浩锋	洪欣	父母
阿姆斯特朗	斯蒂芬·科尼·阿姆斯特朗	父母
林志玲	林志鸿	兄弟姐妹
康康	艾莉丝	情侣
阎锡山	阎书堂	父母
刘阔漳	金杰丽	师生
蒙奇·D·路飞	蒙奇·D·卡普	祖孙
蒋百里	蔡锷	同门
卡斯特罗	阿林娜	父母
熊天荆	伍绍祖	父母
向华强	向前	父母
马三立	王凤山	合作
徐静蕾	黄立行	情侣
毛阿敏	解植坤	夫妻
陈云贤	萧灼基	师生
田士杰	田蕴章	祖孙
文千岁	黄宝任	父母
符光耿	刘蔓	师生
英若诚	英敛之	祖孙
傅志清	傅腾龙	祖孙
龚普生	龚镇洲	父母
周渝民	言承旭	合作
南成哲	李俊日	合作
陈士榘	陈华	父母
陈东升	陆昂	夫妻
吴敦	贾静雯	父母
查尔斯	威廉王子	父母
卡扎菲	哈米斯·卡扎菲	父母
张海	黄鹭	情侣
阿尔伯特·爱因斯坦	赫尔曼·爱因斯坦	父母
王世续	陈秀华	师生
董文华	张楠	情侣
邱胜翊	棒棒堂	合作
王赞策	陈德容	夫妻
袁立	林博文	夫妻
卞之琳	张充和	情侣
李渊	隋炀帝	兄弟姐妹
季承	季羡林	父母
甄姬	袁熙	夫妻
朱德	刘伯承	合作
赵荣琛	程砚秋	师生
蔡葆真	英千里	夫妻
陈香梅	陈纳德	夫妻
王晓临	孙甫亭	师生
蔡和森	李富春	兄弟姐妹
沈比利	比阿特丽斯	兄弟姐妹
陆游	唐婉	夫妻
李烈钧	李赣驹	父母
薛姨妈	薛蟠	父母
关公	关平	父母
黄秀英	包玉刚	夫妻
张传良	蔡波	师生
费雷拉	穆尼里奥	师生
徐建寅	徐寿	父母
李海泉	小生奕	师生
袁阔成	袁杰亭	亲戚
刘家昌	甄珍	夫妻
郑咏恩	官晶华	父母
吕雉	鲁元公主	父母
周侗	史文恭	师生
唐棣华	黄克诚	夫妻
皮克	夏奇拉	情侣
孙协志	韩瑜	情侣
妲己	纣王	夫妻
卢兰	蒋燕皎	合作
刘询	刘据	祖孙
徐根宝	张琳芃	师生
盛中国	濑田裕子	夫妻
陆锦娟	陈必华	合作
李德裕	牛僧孺	合作
徐熙娣	许庆祥	父母
何超莲	何鸿燊	父母
李婷	李娆	兄弟姐妹
郑嘉颖	徐靖雯	情侣
康有为	康赞修	祖孙
林月云	侯世宏	情侣
仲满	武宗文	夫妻
陈松年	陈昔凡	祖孙
黄金宝	沈金康	师生
徐宗汉	黄兴	夫妻
李振辉	李海泉	父母
林超群	林君可	父母
宋文治	陆俨少	同门
乔艳蕊	史冬鹏	夫妻
周采茨	黄浩义	夫妻
钱妙花	傅全香	合作
元睿宗	成吉思汗	父母
史敏	李金鸿	师生
胡斐	袁紫衣	情侣
威廉王子	查尔斯王储	父母
阎世喜	阎金福	祖孙
张小燕	彭国华	夫妻
郎朗	朱雅芬	师生
王学义	段军	师生
竹下登	竹下勇造	父母
李鹏	李小琳	父母
诸葛亮	诸葛怀	父母
王菲	窦靖童	父母
孙峰	夏亚琴	夫妻
廖梦醒	廖凤舒	亲戚
陆士嘉	张维	夫妻
陈颖	王金富	师生
濮存昕	宛萍	夫妻
李宣捷	曹露双	合作
侯长山	侯长清	兄弟姐妹
达尼·阿尔维斯	达尼	合作
叶忠定	叶福海	父母
刘山永	刘衡如	父母
牛桂英	李庭柱	师生
张译	兰晓龙	好友
粟裕	陈毅	亲戚
王祥云	黄良玉	师生
廖仲恺	廖承志	父母
顾毓琇	江泽民	师生
甘夫人	刘备	夫妻
村上春树	阳子	夫妻
叶世长	雷喜福	师生
李政道	张明璋	父母
薛稷	魏叔瑜	亲戚
谭雪	谭富有	父母
贾珍	贾敬	父母
恬妞	万梓良	夫妻
刘銮雄	刘銮鸿	兄弟姐妹
文颂娴	李梓慎	夫妻
王德显	邢慧娜	师生
张光宇	张正宇	兄弟姐妹
韦小宝	阿珂	夫妻
方志敏	方梅	父母
李显龙	何晶	夫妻
宇文恺	宇文忻	兄弟姐妹
胡汉民	胡木兰	父母
许雅钧	许庆祥	父母
张柏芝	狄波拉	父母
闻一多	闻立雕	父母
王健林	王思聪	父母
赵薇	周星驰	合作
余玠	王惟忠	上下级
嵇康	长乐亭主	夫妻
曾山	邓六金	夫妻
刘备	关羽	兄弟姐妹
关正明	李慧芳	合作
杨长智	关心妍	夫妻
罗杰·费德勒	米尔卡	夫妻
张少楼	章晓申	师生
张无忌	谢逊	父母
叶立培	叶立润	兄弟姐妹
乌兰夫	布赫	父母
李敖	王小屯	夫妻
李小林	李先念	父母
何姿	于芬	师生
吴淑珍	赵建铭	父母
阮兆辉	尹飞燕	夫妻
刘伯坚	刘虎	父母
郑振铎	许地山	好友
吴祖强	吴瀛	父母
米雪	雪梨	兄弟姐妹
曹彰	卞氏	父母
许连捷	施文博	合作
周武王	姬昌	父母
王蓉蓉	蔡英莲	师生
甄洛	袁熙	夫妻
张金梁	张春彦	父母
张飞	张苞	父母
张敬轩	关智斌	情侣
程之	程颂万	祖孙
道光	庄顺皇贵妃乌雅氏	夫妻
胡斐	胡一刀	父母
张云溪	迟景昆	父母
官晶华	郑少秋	夫妻
程前	程之	父母
郭春山	曹二庚	师生
李德裕	唐武宗	上下级
林豆豆	叶群	父母
李亚伟	李亚鹏	兄弟姐妹
鲍春来	汤仙虎	师生
陈宝珠	陈宝仪	兄弟姐妹
路易十六	玛丽·安托瓦内特	夫妻
王敏德	马诗慧	夫妻
江竹筠	彭壮壮	祖孙
张一山	张晓武	父母
刘永行	刘永美	兄弟姐妹
伍廷芳	伍荣彰	父母
陈再道	邓小平	合作
戈公振	戈绍甲	兄弟姐妹
多明戈	卡雷拉斯	合作
吴淑珍	陈幸妤	父母
犬大将	杀生丸	父母
赵南哲	木谷实	师生
黄依群	吴素英	同门
张郃	曹操	上下级
林子祥	叶倩文	夫妻
王辉	王建中	夫妻
靓少佳	谭杰南	父母
雷洁琼	雷子昌	父母
深田恭子	五十岚麻朝	情侣
薛觉先	唐雪卿	夫妻
余玠	余如孙	父母
胡兆明	叶玉卿	夫妻
戴季陶	津渊美智子	情侣
于文凤	周星驰	情侣
章伯钧	李哲民	夫妻
林孝贤	林恬儿	兄弟姐妹
普密蓬	玛希敦·阿杜尔雅戴	父母
阎维文	阎晶晶	父母
孙佐臣	金阔亭	师生
罗大翠	周鑫	父母
庄月明	李泽钜	父母
罗大佑	李烈	夫妻
戴志诚	杨蕾	夫妻
孙毓敏	龚苏萍	师生
孙法民	孙道存	父母
孙天牧	卢之美	父母
茹莱卿	董凤岩	同门
谢觉哉	谢宏	父母
刘备	诸葛亮	上下级
施艳飞	易建联	情侣
罗海琼	费麒	夫妻
江石溪	江上青	父母
杨得志	杨成武	合作
孙明珠	马连良	合作
罗启仁	李赛凤	夫妻
郭京飞	鲍莉	夫妻
章小婉	章小蕙	兄弟姐妹
海绵宝宝	派大星	好友
王隆夫	王昌彬	祖孙
陈康堤	陈奕迅	父母
孙策	孙权	兄弟姐妹
李厚霖	李湘	夫妻
蒋友柏	林姮怡	夫妻
关羽	张飞	兄弟姐妹
董笑笑	董浩	父母
江姐	彭壮壮	祖孙
毛泽东	罗一秀	夫妻
妲己	苏护	父母
班彪	班超	父母
杨小娟	吕良国	亲戚
杨孝亭	董魁荣	师生
陈宝珠	杨占美	夫妻
蒋才如	刘德海	同门
杨盛春	杨铁嗣	父母
刘宝全	胡十	师生
洪学智	张文	夫妻
蒋万安	石舫亘	夫妻
丁小芳	金月升	师生
桓玄	桓温	父母
朱天喜	朱星	亲戚
胡兰成	张爱玲	夫妻
蒋经国	章亚若	情侣
高剑父	高瑞彩	祖孙
裘盛戎	裘芸	父母
周美青	马唯中	父母
王祥	朱氏	父母
刘觉民	林觉民	好友
林璎	林长民	祖孙
李爱琴	李三	祖孙
曹爽	曹真	父母
谢景兰	马赛	夫妻
努尔哈赤	塔克世	父母
谭小培	谭元寿	祖孙
路飞	蒙奇·D·卡普	祖孙
徐威	袁立	情侣
张栩	吴清源	师生
林忆莲	李宗盛	夫妻
吴镇	吴泽	祖孙
蔡依伦	蔡绿峰	父母
傅履仁	宗毓珍	夫妻
杨丞琳	刘灏	情侣
陈垣	陈智超	祖孙
蔡瑶铣	朱传茗	师生
冯钟芸	任远	父母
曾国祥	曾志伟	父母
高盛麟	杨小楼	师生
孙穗芳	王祖荣	父母
唐昭宗	唐僖宗	兄弟姐妹
洪秀全	洪天明	父母
小林泉美	小林光一	父母
陈松年	谢氏	祖孙
段正淳	阮星竹	情侣
李菁	师胜杰	师生
梅泽由香里	吉原慎也	夫妻
关海山	关可维	父母
邵华	张文秋	父母
查尔斯王子	戴安娜	夫妻
俞启威	俞珊	兄弟姐妹
王铖湘	徐浩	师生
曹彰	曹楷	父母
马大猷	江泽涵	师生
颜地	方子哥	父母
郭少衡	童玉苓	夫妻
潘光旦	沈恩佩	父母
孙玥	何国文	夫妻
贾政	贾宝玉	父母
郭台铭	曹斯杰	父母
李克用	李存勖	父母
宫本佳代子	泰道照山	祖孙
许志安	余德琳	情侣
金庸	徐志摩	兄弟姐妹
高曙光	江珊	夫妻
徐悲鸿	徐静斐	父母
连战	连横	祖孙
任伯年	任薰	亲戚
孙怡云	罗百岁	父母
张庆鹏	安娜	夫妻
王东红	王美玲	兄弟姐妹
马诗慧	王曼喜	父母
萧盛萱	萧镇奎	祖孙
林晓霖	林彪	父母
章亚若	章浩若	兄弟姐妹
扬古利	纳穆泰	兄弟姐妹
符思思	符敦庄	亲戚
黄贯中	朱茵	夫妻
陈立夫	陈果夫	兄弟姐妹
英若诚	英若娴	兄弟姐妹
何甘棠	李小龙	祖孙
郭晓冬	郭子诚	父母
刘晓江	李恒	夫妻
高维廉	金仲仁	师生
经亨颐	廖承志	父母
方声洞	方贤旭	父母
张维迎	厉以宁	合作
小杰	刚·富力克士	父母
黄光裕	张志铭	兄弟姐妹
基思·鲁珀特·默多克	基思·默多克	父母
赵丹	叶露茜	夫妻
薄谷开来	薄熙来	夫妻
翁家明	俞小凡	夫妻
杜月笙	杜美如	父母
曹宪	曹嵩	祖孙
钱穆	钱逊	父母
高旗	陈娟红	夫妻
陈琳	沈永革	夫妻
史铁生	陈希米	夫妻
尤宪超	高晓攀	合作
汪小菲	汪则翰	父母
张浩	涂俊明	夫妻
孔莹	孔飞越	父母
陈霖苍	陈永玲	父母
华天	华山	父母
徐立清	徐和平	父母
万绮雯	陈十三	夫妻
张之洞	徐致祥	合作
廖凤舒	廖承志	亲戚
查尔斯王储	威廉王子	父母
周瘦鹃	俞文英	夫妻
车宝蓝	车侑蓝	兄弟姐妹
许德义	淑英	夫妻
小钟	王怡仁	情侣
顺治	孝惠章皇后	夫妻
孔子	叔梁纥	父母
干露露	干爸爸	父母
钟鸣岐	李多奎	合作
蒋经国	蒋友梅	祖孙
徐志摩	陆小曼	夫妻
文强	谢才萍	兄弟姐妹
尼古拉·萨科齐	让·萨科齐	父母
李国宝	李冠春	祖孙
段正淳	刀白凤	夫妻
朱经武	陈省身	父母
赫本	艾拉·凡·赫姆斯特拉	父母
谭雪	王海滨	合作
洪煦榆	洪天明	兄弟姐妹
张乐平	冯雏音	夫妻
金月楼	金香琴	合作
李刚	李启铭	父母
杨德昌	蔡琴	夫妻
小乔	乔公	父母
梁靖琪	黄敏豪	情侣
陈汉典	小S	合作
宫崎市定	桑原隲藏	师生
宋丹丹	英达	夫妻
严复	严倚云	祖孙
杨康	包惜弱	父母
谢杏芳	王仪涵	合作
王世臣	谭凤元	合作
郭破虏	武修文	同门
窦靖童	窦唯	父母
高凤山	王学义	合作
耿永山	耿永福	父母
孔令谦	孔伯华	祖孙
梁家树	梁靖琪	父母
曹纯	曹炽	父母
顾颉刚	顾洪	父母
张惠妹	张惠春	兄弟姐妹
谢才萍	文斌	夫妻
张申宏	邹启镇	师生
朱慧珍	邢峰	情侣
安娜	张庆鹏	夫妻
孙佐臣	孙八	父母
盛品儒	吕晶晶	情侣
袁信义	袁祥仁	兄弟姐妹
王政君	王根	兄弟姐妹
夏明翰	郑家钧	夫妻
任剑辉	梁醒波	合作
拖雷	成吉思汗	父母
许冠英	许冠武	兄弟姐妹
武敦儒	郭靖	师生
谢霆锋	谢婷婷	兄弟姐妹
陆锦娟	胡凤英	合作
包陪庆	苏海文	夫妻
卢兰	王仪涵	合作
武修文	武三通	父母
戴思聪	戴辛尉	父母
徐寿	徐建寅	父母
钱嘉乐	洪金宝	师生
杨荣环	雷英	师生
吕光	吕绍	父母
冯巩	刘伟	合作
岳红	岳以恩	父母
邓之诚	张东荪	同门
肃顺	曾国藩	合作
官晶华	郑安仪	父母
盛爱颐	盛宣怀	父母
康盘石	金正恩	祖孙
石玉明	袁生木	父母
池珍熙	李秀妍	夫妻
枣祗	枣处	父母
周蜜	龚睿娜	合作
崔少奎	崔兰田	兄弟姐妹
少女时代	徐珠贤	合作
荀彧	曹操	上下级
杨玄琰	杨玉环	父母
吴汉文	王锡良	师生
慕容垂	慕容恪	兄弟姐妹
钱煦	钱思亮	父母
张卫健	刘德华	好友
班彪	班固	父母
岸边成雄	藤井千代贺	夫妻
顾大嫂	孙新	夫妻
钟鸣岐	李鸣盛	合作
穆里尼奥	菲力克斯·穆里尼奥	父母
孙穗芳	孙穗芬	兄弟姐妹
刘备	孙尚香	夫妻
林散之	黄宾虹	师生
加藤繁	黄现璠	师生
陈鹤年	许桂馨	夫妻
张小燕	张菲	好友
陈松伶	张铎	夫妻
朱丹	宋柯	情侣
李兆会	车晓	夫妻
杨绛	钱瑗	父母
张洛君	王海轮	合作
宋美龄	蒋纬国	父母
张爱玲	李鸿章	祖孙
孔燕松	孔瑶竹	兄弟姐妹
孔东梅	陈东升	夫妻
朱丹	林涵	夫妻
倪桂珍	宋庆龄	父母
和思皇后	唐中宗	夫妻
马晓天	马载尧	父母
田士杰	田起山	父母
钱小豪	郭秀云	夫妻
贾元春	贾政	父母
乔蕙兰	梅兰芳	师生
叶正	叶问	父母
常嘉煌	李承仙	父母
娜美	贝尔梅尔	父母
韦小宝	陈近南	师生
赵婷婷	杨维	合作
窝阔台	贵由	父母
赵晨浩	周杰伦	好友
窦靖童	李亚鹏	父母
王威暘	张秋萍	父母
范瑾	许寿昌	祖孙
孙维世	孙炳文	父母
黄依群	陈辉玲	同门
南希·佩洛西	汤米·亚利桑德罗	父母
妮可·基德曼	凯斯·厄本	夫妻
马连登	马增芬	父母
陈慕华	钟毅	夫妻
陈素真	陈玉亭	父母
白云鹏	阎秋霞	师生
司徒慧聪	萧楷成	师生
刘晓兰	石振发	师生
董必武	董良羽	父母
李兆基	李佩玲	父母
路易十四	路易十五	祖孙
黎洪模	黎昊	祖孙
杨其龙	杨受成	父母
王重阳	马钰	师生
黄秀虹	黄光裕	兄弟姐妹
周令飞	周海婴	父母
叶蓓	陈楚生	好友
格温妮斯·帕特洛	克里斯·马丁	夫妻
陶湘九	郭瑞林	师生
何超琼	许晋亨	夫妻
刘宝瑞	唐杰忠	师生
徐向前	徐小岩	父母
杨庆煌	杨小萍	兄弟姐妹
李新兰	李万春	父母
叶剑波	叶立志	父母
金开芳	张志广	师生
瞿秋白	瞿世玮	父母
汤珈铖	张雨绮	情侣
张闾瑛	张学良	父母
竺基焕	姚月明	师生
老狼	高晓松	合作
赵合德	汉成帝	夫妻
萧亚轩	李安卓	情侣
贾廷聚	唐喜成	师生
罗荣桓	罗东进	父母
南勇	杨一民	合作
谢道韫	王凝之	夫妻
戴碧芝	谢霆锋	兄弟姐妹
耿飚	习近平	上下级
贾樟柯	赵涛	夫妻
张彭春	张明珉	父母
蒋才如	汤寿高	师生
陶晶莹	李李仁	夫妻
章汉夫	龚普生	夫妻
井上真央	松本润	情侣
赵桐珊	王桂山	师生
吴竹似	陈铭德	好友
马英九	马鹤凌	父母
李天秀	安贞焕	合作
马景涛	辛晓琪	兄弟姐妹
王杰	莫绮雯	夫妻
白雪仙	白驹荣	父母
立原久纲	山中鹿之介	亲戚
梵高	提奥	兄弟姐妹
李蓉芳	管韶华	合作
张德武	张文顺	师生
长孙皇后	长孙安业	兄弟姐妹
刘觉民	胡景翼	好友
李蕙仙	梁启超	夫妻
马浚伟	陈志云	上下级
小泉进次郎	小泉孝太郎	兄弟姐妹
王越古	李浩葳	情侣
宋嘉树	宋美龄	父母
程思远	程治平	父母
孔令杰	孔祥熙	父母
筱文滨	邵文滨	师生
方宏进	于红伟	夫妻
冯钰棋	王学兵	夫妻
司马繇	司马睿	亲戚
尹靖	吴峰	师生
周韵	姜文	夫妻
安乐公主	武崇训	夫妻
龙云	龙绳武	父母
齐秦	朱时茂	好友
李亚男	王祖蓝	情侣
埃里克·施密特	拉里·佩奇	合作
萨马兰奇	萨马兰奇·萨利萨奇斯	父母
罗乐林	陈宝仪	夫妻
奚啸伯	李洪春	师生
金妍儿	朴美姬	父母
李虹	李歇浦	父母
耶律倍	辽太宗	兄弟姐妹
金庸	杜治芬	夫妻
田雨	汤唯	情侣
纪里谷和明	宇多田光	夫妻
向华强	陈岚	夫妻
郭台铭	郭晓玲	父母
孔云龙	栾云平	合作
张菲	费贞绫	兄弟姐妹
贾琏	尤二姐	夫妻
迟重瑞	陈丽华	夫妻
杭天琪	莉萨	父母
林信斋	林秉礼	兄弟姐妹
王蕙芳	王少芳	父母
梁挺	李小龙	同门
黄希庭	符明秋	合作
李嘉诚	李泽楷	父母
费孝通	潘光旦	同门
李嘉诚	庄月明	夫妻
李伯祥	李洁尘	父母
金莎	林俊杰	同门
沈葆桢	林则徐	父母
皇甫谧	皇甫方回	父母
马鹤凌	马以南	父母
冯锡范	冯澄世	父母
毛利元就	毛利兴元	兄弟姐妹
凌潇肃	姚晨	夫妻
赵建铭	简水绵	父母
郁达夫	郁嘉玲	祖孙
李禾禾	李肇星	父母
周文王	曹叔振铎	父母
常贵田	常宝华	亲戚
前田利家	前田利昌	父母
赵佩茹	马志存	师生
慕容超	慕容纳	父母
杜如晦	长孙无忌	合作
相来炳	张云标	师生
王昌虎	王乃水	父母
孙眉	孙中山	兄弟姐妹
张治中	洪希厚	夫妻
钟家鸿	陈慧珊	夫妻
郭羡妮	马浚伟	情侣
费德勒	米尔卡	夫妻
大蛇丸	三代火影	师生
金庸	穆旦	兄弟姐妹
陈祖涛	张琴秋	父母
黄光裕	黄俊钦	兄弟姐妹
鲁迅	周令飞	祖孙
庄泳	沈坚强	夫妻
高少亭	李少楼	合作
秦沛	红薇	父母
许玮宁	阮经天	情侣
刘德一	侯跃文	好友
曹露双	刘莹	合作
金孝渊	权侑莉	合作
王必成	瑛	夫妻
周英华	周信芳	父母
大禹	鲧	父母
曾国祥	蔡莹莹	情侣
钟赤兵	李天佑	合作
陈汉文	高德松	师生
杨东虎	李长春	师生
胡敦复	胡卓	亲戚
舒昌玉	朱琴心	师生
斯内德	巴里斯内德	父母
张元和	张允和	兄弟姐妹
小渊惠三	小渊优子	父母
林文龙	林天若	父母
魏萌	魏宁	兄弟姐妹
孙毓敏	张岚芳	师生
郭嘉	郭奕	父母
李兆基	刘惠娟	夫妻
伍文忠	肖国栋	师生
蒋万安	蒋介石	祖孙
柴绍	李渊	父母
尹笑声	尹寿山	父母
马珏	马裕藻	父母
和硕和恪公主	令妃	父母
李保田	陈燕琳	父母
窦靖童	夏桂影	祖孙
贾母	贾赦	父母
孙悟空	哪吒	好友
黄琪翔	郭秀仪	夫妻
赵忠祥	张美珠	夫妻
周培源	冯瑛	父母
柴绍	平阳公主	夫妻
郝润泽	郝海东	父母
鲁迅	周海婴	父母
宋卫平	夏一波	夫妻
邓颖超	周恩来	夫妻
郭跃	张怡宁	合作
梶和为	谷宫悌二	师生
陈幸妤	黄睿靓	兄弟姐妹
孔继宁	李敏	父母
杨淑君	朱木炎	情侣
黎民伟	林楚楚	夫妻
和田清	白鸟库吉	师生
方瑀	连战	夫妻
陈富年	陈彦衡	父母
徐德亮	张文顺	师生
裘盛戎	杨燕毅	师生
阿方索十世	布里特斯	夫妻
金平日	金敬珍	兄弟姐妹
路三宝	梅兰芳	师生
余胜荪	周子衡	师生
种世衡	种师道	祖孙
李赋京	张昌绍	合作
黄光业	赵雅芝	父母
顾毓秀	朱镕基	师生
班昭	班固	兄弟姐妹
佟大方	郭启儒	师生
肯尼迪	帕特里克·肯尼迪	父母
蒋慕萍	蒋鑫棠	父母
林平之	岳灵珊	夫妻
亨利五世	亨利四世	父母
唐在炘	李世济	夫妻
曹仁	曹泰	父母
宋逸民	宋达民	兄弟姐妹
李烈钧	华世琦	夫妻
杨之华	瞿秋白	夫妻
卫子夫	卫青	兄弟姐妹
孙甫亭	王梦云	师生
童葆苓	童芷苓	兄弟姐妹
李凤翔	李文云	父母
叶明子	苏丹丹	父母
陈巧茹	张光茹	师生
劳伦斯·奥利弗	费雯·丽	夫妻
俞振飞	程砚秋	好友
朱青阳	朱时茂	父母
宗泽	宗颖	父母
常宝华	常宝霆	兄弟姐妹
王世霞	王丽卿	父母
贺晓明	贺黎明	兄弟姐妹
徐艳琴	常香玉	合作
阮小二	阮小五	兄弟姐妹
水谷隼	松平健太	合作
曾志伟	洪金宝	师生
杨子	高宁	合作
穆沙拉夫	赛赫巴·穆沙拉夫	夫妻
毛世来	赵桐珊	师生
汤君年	汤子嘉	父母
曹纯	曹演	父母
黄现璠	宫崎市定	同门
郭艾伦	郭凯伦	兄弟姐妹
王小屯	李戡	父母
张桂凤	董柯娣	师生
鲍勃·邓华德	郭士强	合作
郑伊健	陈小春	好友
连战	连惠心	父母
曾宝仪	黄子佼	情侣
赵振铎	王长友	师生
佐藤荣作	佐藤信二	父母
王海燕	张嘉译	夫妻
唐志中	唐威	父母
全公主	周瑜	父母
赵玉吉	宋丹丹	夫妻
曹晖	曹德旺	父母
傅履仁	傅泾波	父母
卫子夫	卫长君	兄弟姐妹
陈红	陈凯歌	夫妻
陈寅恪	陈师曾	兄弟姐妹
郭台铭	曾馨莹	夫妻
江户川柯南	吉田步美	好友
卫长公主	诸邑公主	兄弟姐妹
李依依	柯伟	夫妻
成龙	元武	同门
王文玉	张振圻	师生
孙穗芬	孙中山	祖孙
彭坦	春晓	夫妻
贾又福	叶浅予	师生
许雅钧	黄秀真	父母
杨再石	吴祖仁	合作
陈幸妤	赵建铭	夫妻
石达开	杨秀清	合作
段义和	柳海平	情侣
方子哥	颜地	父母
史静	史玉柱	父母
曹整	曹操	父母
鲁元公主	张偃	父母
金敏智	宋钟基	好友
慕容农	慕容垂	父母
曾宪梓	黄丽群	夫妻
李嘉诚	李嘉昭	兄弟姐妹
彭玘	韩滔	兄弟姐妹
巧姐	王熙凤	父母
古巨基	陈英雪	情侣
侯喜瑞	梅兰芳	合作
张光宇	张仃	好友
梁欢	梁天	兄弟姐妹
谢安	谢裒	父母
孙科	陈淑英	夫妻
向华强	向华胜	兄弟姐妹
王玉璞	杭子和	师生
王光美	刘少奇	夫妻
爱迪生	玛丽·爱迪生	夫妻
聂耳	聂鸿仪	父母
邓演达	邓镜人	父母
宫崎骏	久石让	好友
张松溪	张三丰	师生
叶立培	叶茂菁	父母
解植坤	毛阿敏	夫妻
曾纪泽	曾国藩	父母
柯南	灰原哀	好友
陈毅	赖月明	夫妻
那英	高峰	夫妻
张玉宁	孙佳怡	夫妻
梁邦楚	傅抱石	师生
卫青	公孙敖	好友
王菲	王兆民	祖孙
术赤	斡儿答	父母
上官婉儿	崔湜	情侣
张伯苓	张彭春	兄弟姐妹
刘连玉	周麟阁	同门
王婉华	熊明霞	师生
卢永祥	段祺瑞	好友
汤淼	周苏红	夫妻
荀彧	唐氏	夫妻
俞平伯	胡适	师生
张申府	张濂	父母
李喜儿	林忆莲	父母
常贵田	赵佩茹	师生
周小川	周建南	父母
眭禄	何可欣	合作
周利	阎桂祥	师生
姜亦珊	梅葆玖	师生
谭元寿	谭鑫培	祖孙
谢贤	谢振轩	祖孙
巴金	萧珊	夫妻
宋达泉	朱莲青	合作
郭睿玥	舒昌玉	师生
李纨	贾珠	夫妻
梅艳芳	周星驰	合作
彭儒	陈正人	夫妻
刘云樵	李书文	师生
许爱周	许晋亨	祖孙
卡扎菲	穆罕默德·卡扎菲	父母
苏民	蓝天野	同门
傅腾龙	傅志清	祖孙
张洁清	彭真	夫妻
胡汉民	陈淑子	夫妻
时小福	陈鸣喜	父母
周迅	王朔	情侣
北条氏康	北条氏纲	父母
赵一楠	赵本山	父母
凯特·温斯莱特	莱昂纳多·迪卡普里奥	好友
潘晓婷	张凯	师生
杨诺思	杨永晴	兄弟姐妹
吴健雄	父	父母
李济深	李沛金	父母
姜修智	南宫民	情侣
拔都	别儿哥	兄弟姐妹
俞启威	赵太侔	兄弟姐妹
王烁	王志才	父母
徐若瑄	徐佩瑜	兄弟姐妹
伊维特·普利托	迈克尔·乔丹	情侣
严凯泰	吴舜文	父母
王夫人	贾宝玉	父母
梅葆玥	梅兰芳	父母
张志宽	张子健	父母
孙天牧	孙墨佛	父母
陈小艺	刘惠宁	夫妻
伏明霞	梁司渝	父母
濮方	宛萍	父母
李小龙	丁佩	好友
袁克文	袁克定	兄弟姐妹
鲍惠荞	庄则栋	夫妻
陈寅恪	陈宝箴	祖孙
连战	连胜武	父母
林淑如	黄秋莲	亲戚
俞大维	傅斯年	兄弟姐妹
张浩	林彪	兄弟姐妹
刘宗杨	刘宗年	兄弟姐妹
余胜荪	余紫云	父母
王熙凤	薛宝钗	兄弟姐妹
白全福	于俊波	师生
田丽	陈定中	夫妻
万里	万伯翱	父母
杨荣环	尚小云	师生
关颖	戴瑞穗	祖孙
蔡元培	周峻	夫妻
陈知建	陈赓	父母
张曼玉	宋学祺	情侣
余嘉锡	周祖谟	父母
孙鲁班	孙权	父母
服部半藏	德川家康	上下级
吴郁生	吴承瑛	祖孙
刘外	刘发	祖孙
虎美玲	连德志	师生
卡斯特罗	安赫尔·卡斯特罗	父母
徐贵樱	黄任中	夫妻
叶剑英	吴博	夫妻
王云阶	李青蕙	夫妻
蔡正仁	冯茵华	夫妻
莫言	杜勤兰	夫妻
卫青	卫子夫	兄弟姐妹
杨永晴	杨超成	父母
苍井空	范植伟	情侣
小白玉梅	白玉梅	父母
王海容	王德恒	父母
宫本佳代子	小泉纯一郎	夫妻
胡友松	李宗仁	夫妻
秦始皇	扶苏	父母
王荣山	刘曾复	师生
李隆基	唐睿宗	父母
马鹤凌	马立安	父母
劳君展	许德珩	夫妻
王传一	可米小子	合作
庞伟	王义夫	师生
曹节	曹华	兄弟姐妹
张温	张允	父母
李宗瑞	杨小莉	父母
章遏云	邵佩瑜	师生
郭破虏	耶律齐	兄弟姐妹
应采儿	陈小春	夫妻
叶天士	叶朝采	父母
吴国兴	白海	师生
服部平藏	服部静华	夫妻
林淑如	郭台成	亲戚
韩雨芹	陈英杰	夫妻
毛世来	荀慧生	师生
高雪樵	高俊亭	父母
黄希庭	杨东	合作
王母娘娘	玉皇大帝	夫妻
陈致中	陈幸妤	兄弟姐妹
王祖蓝	李亚男	情侣
傅抱石	傅小石	父母
夏明衡	夏明震	兄弟姐妹
德克·诺维斯基	杰西卡·奥尔森	夫妻
约翰尼·德普	Depp	兄弟姐妹
戴辛尉	谢霆锋	情侣
谢振轩	谢贤	祖孙
夏侯渊	夏侯威	父母
卡扎菲	穆塔西姆·卡扎菲	父母
夏明翰	夏绍范	父母
黄秋莲	游象富	夫妻
海瑞	朱衡	合作
彦涵	黄永玉	合作
周伯通	瑛姑	情侣
庄则栋	鲍惠荞	夫妻
陈毅	王光亚	父母
白全福	缴月舒	师生
白雪仙	梅雪诗	师生
刘宝瑞	马季	师生
王娡	王信	兄弟姐妹
姜文	桑德琳	夫妻
班昭	班超	兄弟姐妹
韩素音	陆文星	夫妻
宋容慧	俞斌	师生
满宠	孔融	合作
王芝泉	松雪芳	师生
邓建国	黄梓琪	夫妻
林则徐	林宾日	父母
经纬	撒贝宁	情侣
高凤山	崔琦	师生
常宝霖	常宝霆	兄弟姐妹
武敦儒	武三娘	父母
林跃	林耀泉	父母
中森明菜	近藤真彦	情侣
常昊	张璇	夫妻
吕碧城	吕美荪	兄弟姐妹
鲍金龙	傅全香	师生
齐秦	孙丽雅	夫妻
曹宝禄	魏金栋	师生
辛笛	徐文绮	夫妻
罗家宝	罗家英	兄弟姐妹
马英九	马莉君	兄弟姐妹
彭咏梧	江竹筠	夫妻
曹嵩	曹操	父母
霍启刚	吕庆欣	情侣
祖冲之	祖暅	父母
吴彦祖	S	夫妻
覃宏	覃辉	兄弟姐妹
黄小茂	史可	夫妻
王姬	高晓飞	父母
韩佳人	延政勋	夫妻
叶群	林立衡	父母
陈阿娇	刘彻	夫妻
马诚方	马恩寿	父母
马潮水	姚方松	师生
吴文藻	冰心	夫妻
王爱爱	程玉英	师生
慕容德	慕容垂	兄弟姐妹
秦琼	李渊	上下级
张彭春	张新月	父母
李度崘	李昌镐	夫妻
苏曼殊	苏杰生	父母
王学圻	王大庆	父母
曾山	曾彩芹	父母
三毛	贾平凹	好友
关栋天	关正明	父母
邓丽君	邓长富	兄弟姐妹
刘谦	黄心琳	情侣
李尚大	李川羽	父母
潘楚颖	潘迪生	父母
程庭华	孙禄堂	师生
吕骥	孙慎	合作
刘永美	刘永行	兄弟姐妹
猪哥亮	高凌风	合作
王石	王宁	父母
张震	张国柱	父母
申东靖	可米小子	合作
姚雪垠	王梅彩	夫妻
肯尼迪	罗伯特·肯尼迪	兄弟姐妹
朱玲玲	郭晶晶	父母
李贞	古天顺	夫妻
朱颖文	陈勤	师生
方冰	方青卓	父母
刘曜	刘阐	父母
刘欢	卢璐	夫妻
高盛麟	丁永利	师生
任伯年	任声鹤	父母
徐天红	吴小楼	合作
李宗盛	李喜儿	父母
高雪樵	金少山	合作
恩格斯	马克思	合作
吉增和	孟广美	情侣
张洛君	汤俊霈	合作
陈浩民	蒋丽莎	夫妻
吕瑞英	张桂凤	合作
张业琳子	张儒兵	父母
冯允庄	司徒阳	合作
赵玉芳	赵本山	父母
阎虹羽	刘琪	师生
赵春芳	杨飞飞	夫妻
陈大悲	陈正薇	父母
巩天阔	巩汉林	父母
蒲添生	蒲宜君	祖孙
宋子文	宋美龄	兄弟姐妹
钱三强	何怡贞	兄弟姐妹
刘渊	刘豹	父母
朱玲玲	霍启人	父母
程莉莎	郭晓冬	夫妻
栾菊杰	顾大进	夫妻
曾启荣	马时亨	亲戚
费孝通	吴泽霖	同门
台静农	鲁迅	好友
赵建铭	赵玉柱	父母
蒋友青	方智怡	父母
李鸣岩	李宏	师生
曹霖	曹髦	父母
郭靖	郭破虏	父母
米家山	潘虹	夫妻
杨尚昆	杨绍明	父母
汉武帝	刘据	父母
薇诺娜·赖德	约翰尼·德普	情侣
毛新宇	毛岸青	父母
安德鲁·约翰逊	罗伯特·约翰逊	父母
秦良玉	马千乘	夫妻
柯南	工藤有希子	父母
魏玩	朱淑贞	好友
元奎	成龙	同门
典韦	曹操	上下级
邵华	毛岸青	夫妻
汪野亭	汪小亭	父母
妃英理	毛利兰	父母
郭跃	牛剑锋	合作
王昆仑	柳亚子	合作
王新欣	张永海	合作
董卓	吕布	父母
张洛君	韩志杰	合作
陈慧珊	钟伟民	夫妻
毛泽覃	贺怡	夫妻
吕雉	吕泽	兄弟姐妹
赵佩茹	高英培	师生
袁绍	袁尚	父母
欧阳山尊	欧阳予倩	父母
罗振玉	罗福苌	父母
蓝心湄	郭彦均	父母
普京	柳德米拉	夫妻
孙穗芬	孙康威	夫妻
杨澄甫	杨振铭	父母
黄雅珉	张世	情侣
皮黔生	皮晓萌	父母
宋达泉	马溶之	合作
施复亮	钟复光	夫妻
唐嘉盛	郭妤浅	父母
蔡明	丁丁	父母
常书鸿	常沙娜	父母
阎晶晶	李肇星	父母
金正日	金正淑	父母
陈若仪	林志颖	夫妻
贾代善	贾母	夫妻
吕后	吕禄	亲戚
濮存昕	韩金凯	父母
朱盛富	朱文英	祖孙
洪秀全	韦昌辉	上下级
孙奋	孙登	兄弟姐妹
陈香梅	廖承志	亲戚
杨虎城	杨瀚	祖孙
王盘声	程文俊	师生
赵伟洲	张志宽	合作
陈济棠	莫秀英	夫妻
林立果	林立衡	兄弟姐妹
刘景然	刘盛道	父母
洪荣宏	洪敬尧	兄弟姐妹
布鲁克斯	兰德里	合作
段正淳	钟灵	父母
赵丽蓉	新凤霞	合作
李国宝	李国能	兄弟姐妹
林敏俐	林国光	父母
黄伯俊	侯佩岑	夫妻
孙芸芸	廖镇汉	夫妻
李海泉	李满甜	亲戚
吴建豪	朱孝天	合作
劳尔·卡斯特罗	菲德尔·卡斯特罗	兄弟姐妹
龚普生	龚澎	兄弟姐妹
赵本山	宋丹丹	合作
周作人	章太炎	师生
梅雨田	梅兰芳	亲戚
唐代宗	睿真皇后	夫妻
王个簃	王少阶	父母
田慧棣	田萱	父母
贾又福	李可染	师生
詹姆斯	格利亚·詹姆斯	父母
詹才芳	杨静	夫妻
张韶涵	姜礼乐	亲戚
陈季同	陈寿彭	兄弟姐妹
唐莉	聂卫平	师生
赵本山	赵德仁	父母
武修文	武敦儒	兄弟姐妹
焦德海	于俊波	师生
赵晨浩	张靓颖	好友
陶经	苏岩	夫妻
狄更斯	伊丽莎白·巴洛	父母
谢朝恩	郑国鸿	合作
景岗山	马葭	夫妻
景岗山	马克坚	父母
袁承志	温青青	夫妻
倪匡	李果珍	夫妻
梅雨田	梅巧玲	父母
孙明珠	孙国良	兄弟姐妹
李相恩	李时炯	亲戚
翁帆	杨振宁	夫妻
李国宝	李民斌	父母
楚原	张活游	父母
王晓临	孟俊泉	夫妻
冯玉祥	冯洪达	父母
夏时济	夏明震	祖孙
孙中山	宋嘉树	父母
傅斯年	傅斯岩	兄弟姐妹
徐立清	徐甘泉	父母
孙国豪	孙诗雯	兄弟姐妹
朱莲芬	顾合祥	父母
艾青	艾梅梅	父母
崔真英	崔真实	兄弟姐妹
鲍文蔚	鲁迅	师生
陈凯歌	陈飞宇	父母
陈意涵	赵又廷	情侣
孙科	孙穗英	父母
钱学森	钱永真	父母
刘宝瑞	周文游	师生
胡茵梦	李敖	夫妻
蒙奇·D·路飞	布鲁克	合作
叶金援	叶盛长	父母
代善	阿济格	兄弟姐妹
袁甲三	袁保恒	父母
苏茹	田不易	夫妻
斯内德	罗德尼·斯内德	兄弟姐妹
朱家鼎	钟楚红	夫妻
罗尔·邓	本·高登	合作
傅雷	傅敏	父母
陶哲轩	梁蕙兰	父母
穆桂英	杨宗保	夫妻
朱光亚	许慧君	夫妻
马莉莉	石筱英	合作
聂凤智	聂庆荣	父母
蔡振华	黄胜	夫妻
朱泳腾	陆毅	同门
左塞尔	卡塞凯姆威	父母
张琼玲	张琼姿	兄弟姐妹
孙多慈	孙传瑗	父母
唐玉成	杨启超	师生
秦怡	金焰	夫妻
许广平	鲁迅	夫妻
秦基伟	唐贤美	夫妻
冯亦代	黄宗英	夫妻
苗丰强	苗华斌	父母
成龙	元奎	同门
筱桂花	萧军	好友
浅田真央	高桥大辅	情侣
欧阳雯鑫	欧阳奋强	父母
陈丽君	陈青远	父母
路飞	娜美	合作
郭晓玲	郭台成	亲戚
沮渠蒙逊	沮渠益生	亲戚
鄢颇	李小冉	情侣
维瓦尔第	乔瓦尼·巴蒂斯塔·维瓦尔第	父母
王梓木	王尔晴	父母
阿姆斯特朗	理查德·戈尔登	合作
赵高	蒙恬	合作
王玉珍	荣少昌	同门
萧红	张廷举	父母
侯勇	潘雨辰	夫妻
方冰	方青媛	父母
黄月山	黄荣胜	父母
习仲勋	习永生	祖孙
洪欣	张丹峰	夫妻
高晓攀	尤宪超	合作
孙治强	孙嘉霖	父母
林海峰	藤田梧郎	师生
何怡贞	葛庭燧	夫妻
李鹏	李小鹏	父母
弗兰克·博尔曼	威廉·安德斯	合作
陈剑	陈婷	兄弟姐妹
瓦特	玛格丽特·米勒	夫妻
徐天红	余彩琴	合作
谢虹雯	王瑶卿	师生
许德珩	许振兴	亲戚
谭孝曾	阎桂祥	夫妻
沈从文	沈虎雏	父母
罗美薇	柏安妮	合作
陶希圣	全汉升	师生
蒋经国	俞大维	亲戚
郭守敬	郭荣	祖孙
朱德	萧菊芳	夫妻
徐伯阳	徐静斐	兄弟姐妹
孟庆南	孟凡博	父母
曹腾	吴氏	夫妻
袁滨忠	韩玉敏	合作
吴石	白崇禧	同门
王岳伦	王诗龄	父母
张灵甫	张道宇	父母
顾城	顾工	父母
邓卓翔	周熠	合作
元彪	洪金宝	同门
赵晨浩	陈慧琳	同门
鲍叔牙	管仲	好友
李彩桦	潘启翀	情侣
马富禄	傅小山	师生
劳尔·阿尔比奥尔	阿尔比奥尔	合作
范姜	钟懿	父母
雷洁琼	严景耀	夫妻
庞清	姚滨	师生
陈玉成	李秀成	合作
唐韵	马景涛	夫妻
李小龙	李振辉	兄弟姐妹
于俊波	戴少甫	合作
王愿坚	王振千	父母
曾国荃	曾国藩	兄弟姐妹
小香玉	张洁	同门
瞿同祖	瞿宣颖	亲戚
彭德怀	浦安修	夫妻
赵薇	叶茂青	情侣
邓林	邓小平	父母
成龙	邓丽君	好友
于若木	陈云	夫妻
刘质平	弘一法师	师生
玄彬	宋慧乔	情侣
钟鸣岐	侯喜瑞	合作
傅作义	傅琪	亲戚
浦熙修	袁冬林	父母
黑泽明	高峰秀子	夫妻
常东升	林起凯	师生
王振义	陈赛娟	师生
刘纯燕	刘兴沛	父母
小S	徐坚	父母
吴孟达	周星驰	合作
高长恭	郑氏	夫妻
黄希庭	李红	合作
倪萍	陈凯歌	情侣
朱迅	王志	夫妻
俞大维	蒋孝章	父母
李堂堂	陈建梅	情侣
武敦儒	武修文	兄弟姐妹
莫文骅	毛泽东	合作
叔本华	约翰娜·叔本华	父母
蒋万安	蒋惠筠	兄弟姐妹
蒋碧薇	徐悲鸿	夫妻
傅荣斌	陆昌立	师生
刘国正	刘邦云	父母
李树建	高红岩	师生
武宗文	仲满	夫妻
曹仁	曹褒	祖孙
张纯如	张盈盈	父母
阎岚秋	朱文英	父母
陈水扁	陈幸妤	父母
潘石屹	冯仑	合作
林觉民	陈意映	夫妻
乌塞恩·博尔特	Davis	祖孙
陶哲轩	劳拉	夫妻
胡启立	郝克明	夫妻
汉光武帝	刘縯	兄弟姐妹
波什	詹姆斯	合作
谢天顺	何云伟	合作
周伯宜	鲁瑞	夫妻
杨泓	刘孜	夫妻
金惠秀	金东勋	兄弟姐妹
李立山	高元钧	师生
薄熙宁	薄熙来	兄弟姐妹
孙毓敏	陈静	师生
姜亦珊	薛亚萍	师生
元华	成龙	合作
李济深	李沛瑶	父母
苏海文	包玉刚	父母
许德珩	许鹿希	父母
林徽因	金岳霖	好友
甄姬	曹丕	夫妻
谢君豪	苏玉华	好友
吴国桢	黄卓群	夫妻
阿诺·施瓦辛格	玛丽娅·施莱弗	夫妻
杨千霈	霍启人	情侣
梅巧玲	梅竹芬	父母
童芷苓	童葆苓	兄弟姐妹
姜大卫	严化	父母
李根源	李希泌	父母
陈赛娟	王振义	师生
郭德纲	陶阳	父母
常香玉	张福仙	父母
内藤大湖	内藤荣子	兄弟姐妹
刘翔	吉粉花	父母
袁克权	端方	父母
张敬轩	王菀之	情侣
张黎	刘蓓	夫妻
代善	莽古尔泰	兄弟姐妹
谭元寿	谭韵寿	兄弟姐妹
钱钟书	钱基博	父母
王仁甫	季芹	夫妻
黄有龙	赵薇	夫妻
赵伟洲	杨少华	合作
阿尔伯特·爱因斯坦	爱德华·爱因斯坦	父母
尹明善	陈巧凤	夫妻
李多奎	王梦云	师生
赵叔孺	林寿图	亲戚
蒋孝严	蒋得元	祖孙
亨利·福特	埃兹尔·福特	父母
梁晓天	梁天	父母
卫诗	关楚耀	情侣
贾静雯	孙志浩	夫妻
姚名达	姚芳权	父母
白鸟库吉	原田淑人	师生
康健海	魏孝忠	师生
陈云凤	夏明翰	父母
陈金莲	戚雅仙	合作
罗明珠	林珊珊	合作
赵婷婷	魏轶力	合作
周迅	范晓萱	好友
汪长诗	汪德官	父母
周瑜	小乔	夫妻
金铁霖	金圣权	父母
沈世启	宋国祥	师生
武魁海	魏文华	师生
田起山	田连章	父母
姜戎	张抗抗	夫妻
周冬齐	林永健	夫妻
孟令源	蔡亮	合作
姜珊	姜昆	父母
夏侯渊	夏侯称	父母
海绵宝宝	松鼠桑迪·奇克斯	好友
张之洞	李鸿章	合作
卡雷拉斯	梅塞德丝	夫妻
刘宝瑞	高洪顺	师生
张兰	汪则翰	夫妻
陈松年	陈独秀	父母
太平公主	薛绍	夫妻
张敬修	张居正	父母
孙正阳	梁连柱	师生
秦始皇	秦惠文王驷	祖孙
普希金	娜塔丽娅·普希金娜	夫妻
经亨颐	经普椿	父母
钱穆	钱婉约	祖孙
林美贞	孙兴	夫妻
陈毅	张茜	夫妻
王海容	唐闻生	合作
殷离	张无忌	兄弟姐妹
周韵	姜一郎	父母
李颖芝	房祖名	情侣
彭佩云	王汉斌	夫妻
谢天顺	孔云龙	合作
唐英年	唐嘉盛	父母
曹操	曹植	父母
邓敏	梅葆玖	师生
郑成功	郑克塽	祖孙
蒋纬国	陈洁如	父母
叶步青	徐尚田	同门
包天笑	包子青	兄弟姐妹
林翠	秦剑	夫妻
王维秋	金仲仁	师生
班婕妤	班况	父母
小花玉兰	陈艳楼	父母
亨利五世	亨利六世	父母
张楚儿	蔡少芬	父母
罗从彦	李桐	师生
王向党	王向国	兄弟姐妹
魏东	魏振雄	父母
蒙其·D·路飞	波特卡斯·D·艾斯	兄弟姐妹
曾国犹	曾国祥	兄弟姐妹
马英九	秦厚修	父母
劳德诺	令狐冲	同门
津渊美智子	蒋纬国	父母
郭少安	王泳泉	父母
周建人	周作人	兄弟姐妹
梁天	梁左	兄弟姐妹
王薇薇	王澄清	父母
潘阳	杨云	父母
郝为真	李亦畲	师生
刘亚男	王海川	夫妻
姚苌	姚弋仲	父母
杨贵妃	唐玄宗	夫妻
施复亮	施光南	父母
梁少芯	文千岁	夫妻
徐静斐	黎应图	父母
吴敦义	吴子廉	父母
李艳芳	余彩琴	合作
刘砚芳	高盛麟	父母
马晨菲	马文广	父母
安德烈·金	崔敬子	师生
小S	许雅钧	夫妻
陈竺	王振义	师生
金平日	金正日	兄弟姐妹
郝景盛	赵为楣	夫妻
康盘石	康敦煜	父母
潘公凯	潘天寿	父母
陈升	刘若英	师生
谢晓虹	薛伟森	父母
霍英东	霍耀容	父母
陈金飞	刘亦菲	父母
吕良伟	邝美云	夫妻
邓稼先	许德珩	父母
孔令侃	孔祥熙	父母
滕丽名	郭政鸿	情侣
董必武	董良翚	父母
玄彬	黄智贤	情侣
支维永	陶素莲	合作
文熙俊	文慧丽	兄弟姐妹
潘迪生	潘锦溪	父母
大S	许雅钧	兄弟姐妹
赵志刚	尹桂芳	师生
胡适	胡祖望	父母
李可染	李小可	父母
贾元春	王夫人	父母
冯景兰	冯钟芸	父母
谷祖琳	谷德昭	亲戚
钱琳琳	郑弘	夫妻
柯蓝	李泉	情侣
彦涵	白桦	父母
布拉德·皮特	珍妮佛·安妮斯顿	夫妻
王晶华	王玉璞	兄弟姐妹
胡松华	胡宝善	兄弟姐妹
全智贤	张赫	好友
孙科	孙穗华	父母
马增芬	马增蕙	兄弟姐妹
章遏云	古爱莲	师生
田汉	聂耳	好友
童芷苓	童祥苓	兄弟姐妹
沮渠蒙逊	沮渠牧犍	父母
陈三立	陈寅恪	父母
李立三	李莎	夫妻
樊粹庭	陈素真	合作
秦始皇	高	父母
李婷芷	马景涛	情侣
陈宰均	陈朝玉	师生
高以翔	周汶锜	情侣
白雪仙	龙剑笙	师生
曾美娟	汪嵩	情侣
徐尚田	李小龙	同门
苻坚	苻洪	兄弟姐妹
程昱	程武	父母
纳扎尔巴耶夫	萨拉·阿尔贝索芙娜·纳扎尔巴耶娃	夫妻
王稼祥	朱仲丽	夫妻
陈龙灿	韦晴光	合作
奥巴马	玛丽亚·安·奥巴马	父母
哈文	法图麦·李	父母
杨柳	哈辉	夫妻
徐梦桃	徐学君	父母
康康	李世贤	好友
任重	张铎	同门
任剑辉	靓次伯	合作
张克群	陆士嘉	父母
李奎光	王桂香	夫妻
马莉莉	邵滨孙	合作
高剑父	高保样	父母
爱因斯坦	赫尔曼·爱因斯坦	父母
桑振君	胡小凤	师生
许银川	文静	夫妻
杨钰莹	毛宁	好友
秦德君	刘伯坚	情侣
辽景宗	辽世宗	父母
伊瓜因	豪尔赫·伊瓜因	父母
刘威	何晴	情侣
刘思齐	张文秋	父母
汉武帝	刘髆	父母
曾志伟	曾宝仪	父母
连胜文	连横	祖孙
谭正岩	谭元寿	祖孙
余立金	陆力行	夫妻
秦沛	尔冬升	兄弟姐妹
蒋碧薇	徐伯阳	父母
吴佩孚	张佩兰	夫妻
何念慈	孙芸芸	父母
鲍令晖	鲍照	兄弟姐妹
李四广	李顺德	父母
孙芸芸	孙道存	父母
赖昌星	赖水强	兄弟姐妹
李天恩	谢天华	夫妻
罗振玉	罗继祖	祖孙
巩天阔	潘阳	好友
刘禅	刘瑶	父母
赵一曼	陈达邦	夫妻
兰德里	姚明	合作
郑中基	余思敏	夫妻
刘若英	苏慧伦	好友
郭德纲	范振钰	合作
项英	项苏云	父母
耿永山	耿永清	父母
曹均	曹茂	兄弟姐妹
梅雨田	茹莱卿	师生
尔冬升	父尔光	父母
蒋蓉	蒋鸿泉	父母
李亨	李僩	父母
闻一多	闻黎明	祖孙
周作人	周吉宜	祖孙
谭富英	谭韵寿	父母
成惠琳	李南玉	亲戚
谢振南	谢婷婷	亲戚
尤三姐	柳湘莲	情侣
陈奇涵	徐海东	合作
伊斯林·阿巴斯	赛义德·阿巴斯	兄弟姐妹
马雪阳	至上励合	合作
孙权	孙亮	父母
张翠山	俞莲舟	同门
车范根	车杜里	父母
阚泽良	华连仲	师生
粟裕	陈小鲁	父母
唐英年	唐翔千	父母
金弘业	金大中	父母
刘濞	刘仲	父母
袁茵	戴志诚	夫妻
梅泽由香里	加藤正夫	师生
张云霞	徐天红	合作
新凤霞	齐白石	师生
史敏	杨秋玲	师生
郭襄	郭靖	父母
陆士嘉	张克群	父母
刘允若	何葆贞	父母
梁思宁	王桂荃	父母
张茜	张卫健	夫妻
金素琴	金素雯	兄弟姐妹
刘晓庆	王立	夫妻
王滢	庾澄庆	亲戚
白崇禧	白崇勋	兄弟姐妹
谢娜	张杰	夫妻
孙中山	孔祥熙	兄弟姐妹
汤敏	袁阔成	师生
亨利二世	阿基坦的埃莉诺	夫妻
徐子淇	李家诚	夫妻
罗便臣	夏乔士•罗便臣	父母
李长治	李泽楷	父母
黄博文	李甜甜	夫妻
曾国华	刘时铁	夫妻
谢才萍	文强	亲戚
曹霖	曹丕	父母
陈慧琳	刘昇	父母
梅艳芳	覃美金	父母
周恩来	万冬儿	父母
焦刘洋	刘淑华	父母
韩冬柏	梅葆玖	师生
孙楠	买红妹	夫妻
顾传琳	顾传玠	兄弟姐妹
黄子佼	夏宇童	夫妻
宇多田光	纪里谷和明	夫妻
洪秀全	洪仁玕	兄弟姐妹
叶翠翠	黄有龙	情侣
高玉秋	晏霁	夫妻
松井大辅	加藤罗莎	夫妻
徐兰沅	徐阿四	祖孙
邓健泓	陈志云	师生
林挺生	李夫人	夫妻
小林光一	木谷礼子	夫妻
叶剑英	曾宪植	夫妻
付洋	傅彦	兄弟姐妹
黄绍竑	蒋介石	上下级
谭元寿	谭小培	祖孙
黄霑	林燕妮	夫妻
康生	曹轶欧	夫妻
张柏芝	张豪龙	兄弟姐妹
郭晶晶	霍启刚	夫妻
吴建豪	周渝民	合作
沈嘉伟	沈月	父母
令狐冲	任盈盈	夫妻
汉光武	刘縯	兄弟姐妹
杨嘉源	杨嘉荣	兄弟姐妹
李小龙	李海泉	父母
练海棠	伍咏薇	夫妻
旋涡鸣人	波风水门	父母
杨蕾	魏积安	合作
白雪仙	任剑辉	合作
李可染	邓伟	师生
萧红	萧军	夫妻
许崇清	许崇灏	兄弟姐妹
彭壮壮	彭云	父母
余叔岩	余三胜	祖孙
陆锦娟	余彩琴	合作
范仲淹	种世衡	合作
靓元亨	蛇王苏	父母
刘长卿	章八元	好友
亨利	妮可·梅丽	夫妻
方静	郭兰英	师生
李晓霞	李隼	师生
鲁肃	周瑜	好友
侯喜瑞	高庆奎	合作
赵建铭	吴淑珍	父母
成吉思汗	术赤	父母
王翔千	王辩	父母
何猷启	陈婉珍	父母
索菲亚·罗兰	卡洛·庞帝	夫妻
陈公博	李励庄	夫妻
陈涌泉	陈子贞	父母
郭女王	郭永	父母
谭世秀	谭世安	兄弟姐妹
阿朵	高晓松	情侣
三毛	齐豫	好友
李荣威	孙盛文	师生
蔡少芬	吴奇隆	情侣
李菁	郭一薇	夫妻
邓卓翔	高洪波	师生
伊瓜因	马拉多纳	师生
陈嘉梁	梅兰芳	师生
林楚楚	黎民伟	夫妻
他信·西那瓦	朴乍曼	夫妻
小早川隆景	毛利辉元	亲戚
田中直纪	田中真纪子	夫妻
阮斐	项堃	夫妻
叶崇仁	叶玉卿	亲戚
刘德一	刘乙麟	父母
徐熙媛	张兰	父母
伍咏薇	翁江培	夫妻
徐静斐	黎洪模	夫妻
葛洪	郑隐	师生
张温	张祗	兄弟姐妹
武田信玄	武田胜赖	父母
小乔	孙策	兄弟姐妹
陈垣	陈述	师生
郭麒麟	郭德纲	父母
何厚铧	何贤	父母
李永波	李根	父母
金大中	李姬镐	夫妻
斛律金	斛律羡	父母
张靓颖	冯轲	情侣
慈少泉	曹二庚	师生
辛柏青	朱媛媛	夫妻
梅艳芳	张国荣	好友
郁达夫	郁飞	父母
连战	蔡依珊	父母
蒋友梅	徐乃锦	父母
贾政	贾母	父母
徐天红	筱丹桂	合作
常宝霆	常宝霖	兄弟姐妹
马寅初	王仲贞	夫妻
宋江	戴宗	好友
梁思忠	梁启超	父母
胡佛	卢·胡佛	夫妻
王学圻	孙昌宁	夫妻
陈赓	陈知进	父母
彭康育	5566	合作
琦君	李唐基	夫妻
曹睿	曹操	祖孙
周璟馨	鲁迅	祖孙
徐佩瑜	徐若瑄	兄弟姐妹
白驹荣	白雪仙	父母
任美锷	许丽云	夫妻
康子林	岳春	师生
浦洁修	浦通修	兄弟姐妹
路永佳	蔡依珊	兄弟姐妹
金焰	王人美	夫妻
贝时璋	程亦明	夫妻
顾谦	尚长荣	师生
俞大维	俞明震	亲戚
陈若仪	小小志	父母
莫文骅	杨枫	夫妻
王辩	王希坚	兄弟姐妹
丛珊	丛兆桓	父母
谢天华	陈小春	合作
张元和	顾传玠	夫妻
许玮伦	杨丞琳	好友
侯世宏	侯佩岑	父母
华佗	樊阿	师生
李金泉	马连良	合作
孙中山	孙眉	兄弟姐妹
犀利哥	程国圣	兄弟姐妹
董凤年	孙老元	师生
马悦卿	戴德顺	师生
小王玉蓉	王玉蓉	父母
俞敏洪	徐小平	合作
罗京	邢质斌	合作
郭晓玲	林淑如	父母
吕凉	宋忆宁	夫妻
慕容皝	段氏	父母
鑫艳玲	赵萍	父母
方伟	齐秦	父母
张文涓	陈秀华	师生
陈独秀	陈鹤年	父母
包玉刚	包陪庆	父母
卫长公主	石邑公主	兄弟姐妹
吴凤花	吴素英	合作
李玉茹	李少春	合作
贾政	贾元春	父母
叶挺	叶正光	父母
赵贞玉	苗文华	同门
博比·肯	张雯婷	夫妻
谭其骧	黄现璠	同门
谢东	侯耀文	兄弟姐妹
王敏德	王盛德	兄弟姐妹
马浚伟	郭羡妮	情侣
伊丽莎白·泰勒	弗朗西斯·泰勒	父母
张子健	梁冠华	好友
蒋孝勇	方智怡	夫妻
章伯钧	章诒学	父母
柏立基	安柏立基	夫妻
费英东	索尔果	父母
刘世定	刘文辉	祖孙
牛魔王	玉面狐狸	情侣
芮乃伟	江铸久	夫妻
刘诗雯	张继科	情侣
陈祖涛	陈昌浩	父母
陆定一	陆澄宙	父母
甄洛	曹睿	父母
王尚荣	克	夫妻
李小龙	叶问	师生
Selina	Ella	合作
李金枝	常香玉	师生
林徽因	林孝恂	祖孙
李经文	刘中石	师生
庄月明	李泽楷	父母
唐祖宣	周连三	师生
栾菊杰	栾菊红	兄弟姐妹
吴碧霞	金铁霖	师生
孙悟空	菩提祖师	师生
曹整	李姬	父母
邓丽君	保罗	情侣
傅抱石	傅益玉	父母
郭子仪	郭敬之	父母
刘宝全	谭凤元	师生
欧阳龙	傅娟	夫妻
杨宝森	杨文蕙	父母
马海龙	吴英华	父母
唐莉	曹大元	师生
乌兰夫	孔飞	兄弟姐妹
杜致礼	杨光诺	父母
李书福	李星星	父母
柏安妮	罗美薇	合作
戴军	雪村	合作
金日成	金亨稷	父母
刘彻	卫子夫	夫妻
刘协	伏寿	夫妻
孟俊泉	裘盛戎	师生
洪煦榆	洪天祥	兄弟姐妹
杨福元	杨隆寿	父母
张宁	王仪涵	合作
孙连仲	孙惠书	父母
周信芳	周少麟	父母
郭沫若	郭民英	父母
陶阳	陶俊	兄弟姐妹
陈小汉	李敏华	师生
狄波拉	谢婷婷	父母
何爱喻	李小龙	父母
卓琳	邓朴方	父母
刘晓庆	阿峰	夫妻
陈仁麒	萍	夫妻
宋远桥	宋青书	父母
陶菲克	古健杰	合作
陶晴贤	大内义隆	上下级
张兰	田益宾	夫妻
唐高宗	唐太宗	父母
王德显	艾冬梅	师生
玄彬	金泰熙	情侣
张国立	张铁林	好友
韩雨芹	张国立	师生
冯弘	冯朗	父母
胡适	韦莲司	好友
代善	皇太极	兄弟姐妹
刘备	张飞	兄弟姐妹
上官小妹	刘弗陵	夫妻
拿破仑	约瑟菲娜·德博阿尔内	夫妻
吕碧城	吕坤秀	兄弟姐妹
马连良	王慧如	夫妻
董方卓	徐弘	师生
苏童	叶兆言	好友
薛永年	范志强	师生
刘欢	韦唯	合作
程之	程君谋	父母
拉登	瓦法赫·杜福尔	亲戚
工藤静香	酒井法子	好友
洪煦榆	曹恩玉	父母
李菁	金文声	师生
张立辰	潘天寿	师生
罗大翠	周正龙	夫妻
吴雁泽	林西琳	夫妻
曹徽	曹昂	兄弟姐妹
张小凡	宋大仁	同门
丁果仙	张鸣琴	师生
刘觉民	康有为	师生
赵括	赵奢	父母
冯巩	冯国璋	祖孙
郭士强	蒋兴权	师生
大S	蓝正龙	情侣
孟遏云	孟光华	父母
谢亚龙	蔚少辉	合作
陈奕迅	徐濠萦	夫妻
张家辉	关咏荷	夫妻
阎笑儒	宋玉清	师生
夏明衡	郑哲生	夫妻
劳德诺	岳不群	师生
齐宝玉	张文涓	师生
杨博	杨亚洲	父母
薄熙莹	薄一波	父母
刘志坚	刘莱瑛	夫妻
王宠惠	杨兆良	夫妻
司马邺	司马炎	祖孙
王重阳	刘处玄	师生
黄秋燕	黄伯寿	父母
阳友鹤	周慕莲	同门
窦颖	窦唯	兄弟姐妹
郭德纲	侯耀文	师生
刘半农	屠敬山	师生
李宝櫆	尚小云	亲戚
郭全宝	侯宝林	合作
陆侃如	冯沅君	夫妻
贾代善	贾政	父母
余音	焦裕禄	祖孙
汉成帝	王莽	兄弟姐妹
马良	马秉	父母
孝圣宪皇后	康熙	父母
马英九	马元中	父母
倪萍	杨亚洲	情侣
许冠杰	许冠英	兄弟姐妹
章子怡	艾维·尼沃夫	情侣
袁术	袁绍	兄弟姐妹
刘完素	朱丹溪	师生
蒋纬国	蒋介石	父母
孙协志	5566	合作
黄睿靓	黄百禄	父母
徐宗汉	李应生	亲戚
琦琦	任达华	夫妻
姚水娟	李艳芳	合作
袁世海	叶福海	师生
姜文	周韵	夫妻
罗瑞卿	罗箭	父母
他信	朴乍曼	夫妻
沈湘	殷秀梅	师生
梵高	高更	好友
翟燕身	周海水	合作
耿乐	柯蓝	情侣
徐玉兰	赵瑞花	合作
真田幸村	片仓重纲	父母
钱小豪	钱嘉乐	兄弟姐妹
姜宁	刘春明	师生
关海山	关聪	父母
刘洋	张华	夫妻
廖亦崟	棒棒堂	合作
黄旭	尹学香	父母
曾少宗	可米小子	合作
阮小二	阮小七	兄弟姐妹
李家杰	李兆基	父母
慕容皝	慕容垂	父母
黄百禄	黄睿靓	父母
曾念平	李少红	夫妻
李国庆	俞渝	夫妻
杜淳	杜志国	父母
赛义德·阿巴斯	伊斯林·阿巴斯	兄弟姐妹
钟镇涛	范姜	情侣
具惠善	李民浩	情侣
林则徐	林霈霖	兄弟姐妹
金吒	木吒	兄弟姐妹
言少朋	言菊朋	父母
许雅钧	徐熙娣	夫妻
宋子文	倪桂珍	父母
金庸	朱玫	夫妻
戴季陶	钮有恒	夫妻
洪雁	莫少聪	情侣
王光亚	陈珊珊	夫妻
孙虑	孙权	父母
蒋勤勤	陈建斌	夫妻
陶菲克	陈文宏	合作
冯钟芸	冯景兰	父母
陈晓旭	陈晓阳	兄弟姐妹
罗文	黎姿	师生
门德尔松	摩西·门德尔松	祖孙
黄炎培	王纠思	夫妻
鲜灵霞	小鲜灵霞	师生
李俊玲	赵吟秋	师生
张立媛	沈世华	师生
魏东	魏峰	兄弟姐妹
王重阳	孙不二	师生
王弢	王茂俊	父母
崔田民	崔田夫	兄弟姐妹
鲜灵霞	刘凤华	师生
贝克汉姆	罗密欧·贝克汉姆	父母
钱穆	胡美琦	夫妻
野比大雄	野比玉子	父母
费俊龙	费长宝	父母
巩天阔	金珠	父母
唐生智	唐仁曼	父母
刘家良	翁静晶	夫妻
李宗瑞	李岳苍	父母
贾廷聚	申小梅	合作
方声洞	王颖	夫妻
卡雷拉斯	帕瓦罗蒂	合作
陈撄宁	昊彝珠	夫妻
金东文	罗景民	夫妻
任剑辉	薛觉先	合作
张艾嘉	王靖雄	夫妻
兰陵王	乐安公主	兄弟姐妹
陈照旭	陈发科	父母
方美芳	齐秦	情侣
王俪桥	李泽钜	夫妻
罗家英	汪明荃	夫妻
崔始源	金希澈	合作
李国静	杨秋玲	师生
伊丽莎白一世	安妮·博林	父母
吴敬琏	黄圣依	亲戚
桑振君	苗文华	师生
杨澄甫	郑曼青	师生
梁思永	林徽因	兄弟姐妹
李海泉	李小龙	父母
吕大临	吕大钧	兄弟姐妹
黎民伟	严浩波	父母
张飞	夏侯氏	夫妻
黄昆	黄燕	兄弟姐妹
黄日华	梁洁华	夫妻
段正淳	段正明	兄弟姐妹
袁阔成	汪文华	师生
李昌镐	李英镐	兄弟姐妹
顾慰连	顾毓琇	父母
李恒	胡耀邦	父母
聂荣臻	丁衡高	父母
李小琳	刘智源	夫妻
巩汉林	金珠	夫妻
李小璐	贾乃亮	夫妻
阿尔法	李雨轩	合作
孙峰	孙玉才	父母
常宝华	常贵田	亲戚
眭禄	江钰源	合作
沙奎尔·奥尼尔	布朗	师生
李思训	李昭道	父母
秦汉	孙元良	父母
马景涛	马世心	父母
邱钟惠	韩模宁	夫妻
贺龙	徐月姑	夫妻
罗从彦	杨时	师生
刘欢	刘一丝	父母
李海泉	何金棠	夫妻
葛淑珍	赵本山	夫妻
曹斯杰	曹麟根	祖孙
吴征镒	段金玉	夫妻
谭咏麟	杨洁薇	夫妻
沈烨	田卿	情侣
李浩天	李宝春	兄弟姐妹
陈荟莲	陈首林	父母
撒切尔	派翠丝•罗伯茨	父母
那海	恰卡	父母
袁绍	袁熙	父母
任小蕾	任永华	父母
费英东	代善	合作
侯耀文	陈一嘉	情侣
萧纶	萧衍	父母
威廉·安德斯	弗兰克·博尔曼	合作
白凤鸣	刘宝全	师生
欧阳奋强	欧阳雯鑫	父母
孙徐春	茅善玉	同门
万宝宝	万里	祖孙
马思纯	顾长卫	亲戚
李存义	陈泮岭	师生
邓育昆	邓天星	父母
苻坚	苻雄	父母
白浪	郎平	父母
杨不悔	殷梨亭	夫妻
郭睿玥	李丽芳	师生
郁达夫	郁天民	父母
汪诗诗	甄子丹	夫妻
王明华	梅兰芳	夫妻
慕容垂	慕容德	兄弟姐妹
张文顺	李菁	合作
毕渊明	毕伯涛	父母
张艺谋	张末	父母
李鸿章	李经方	父母
孙墨佛	孙天牧	父母
刘景然	刘盛通	父母
屠杏花	白玉梅	合作
何东	麦秀英	夫妻
陈楠	隋菲菲	合作
鲍莉	郭京飞	夫妻
许鹿希	许德珩	父母
章子怡	周迅	好友
李金泉	李少春	合作
夏姬	夏南	父母
薛永年	夏雨田	合作
吕洋	李世济	师生
小林泉美	小林礼子	师生
王丽卿	王世霞	父母
贾玲	冯巩	师生
松岛菜菜子	反町隆史	夫妻
高吹万	高锟	祖孙
邓华德	郭士强	合作
王义夫	张秋萍	夫妻
聂耳	彭寂宽	父母
解丰鸣	解植坤	父母
张茜	严宽	好友
猪八戒	白龙马	同门
茅威涛	尹小芳	同门
刘至翰	林子萱	夫妻
东条英机	东条英教	父母
小沈阳	洋洋	父母
林觉民	林长民	兄弟姐妹
杨立铭	夏培肃	夫妻
郝海东	郝润泽	父母
周文王	卫康叔	父母
夏明震	夏时济	祖孙
毛东东	毛甜懿	兄弟姐妹
荣毅仁	荣智健	父母
李宝英	赵显宰	好友
蔡葆真	蔡儒楷	父母
刘玉栋	吴乃群	合作
马敬伯	马桂元	父母
赵晓梅	阎立品	师生
赵兵伟	牛淑贤	师生
萨科齐	路易斯·萨科齐	父母
安德鲁·约翰逊	玛丽·约翰逊·斯托弗·布朗	父母
李双江	李贺	父母
王濛	李琰	师生
杨班侯	李万成	师生
麦凯恩	辛蒂·亨丝莉·麦凯恩	夫妻
全公主	步夫人	父母
李国宝	李国章	兄弟姐妹
和珅	丰绅殷德	父母
王令尘	张艾嘉	父母
蒋才如	蒋倩竹	父母
邹兆龙	洪金宝	师生
冯培澜	梁存真	好友
刘德一	李洁	夫妻
程潜	郭翼青	夫妻
罗鹰石	罗嘉瑞	父母
梁静慈	甄子丹	夫妻
吴大观	王大地主	亲戚
本杰明	本杰明	祖孙
石班瑜	周星驰	合作
成龙	陈月荣	父母
尤彩云	丁兰荪	师生
黄君璧	李瑶屏	师生
高胜泉	高庆奎	亲戚
杨小楼	杨月楼	父母
霍震霆	霍启人	父母
谢贤	张柏芝	父母
刘砚芳	刘宗年	父母
王玉珍	刘连玉	同门
方智怡	方恩绪	父母
犬夜叉	桔梗	夫妻
杨洁薇	谭咏麟	夫妻
杨爱瑾	郭永淳	情侣
方志敏	方明	父母
邓榕	贺平	夫妻
吴炳璋	吴松岩	父母
元彪	元武	合作
夏明翰	夏明震	兄弟姐妹
王珞丹	黄圣依	同门
刘少奇	何葆贞	夫妻
曹华	曹节	兄弟姐妹
周敦颐	程颢	师生
王娡	田胜	兄弟姐妹
关之琳	陈泰铭	情侣
贾珠	贾兰	父母
成龙	吴卓林	父母
赵小兰	赵锡成	父母
王姬	高晓天	父母
张爱玲	张佩纶	祖孙
陈颖	秦彰	师生
梦鸽	李双江	夫妻
慕容垂	慕容宝	父母
倪匡	倪穗	父母
戴庚玲	麦浚龙	情侣
石原慎太郎	石原伸晃	父母
Hebe	Selina	合作
莫科	莫连贵	父母
孙协志	王绍伟	合作
金敏喜	李政宰	情侣
黄锦燊	赵雅芝	夫妻
汪小菲	许雅钧	兄弟姐妹
荀彧	夏侯惇	合作
黄廷方	黄志祥	父母
李嘉欣	许晋亨	夫妻
陈毅	陈昊苏	父母
曹其敏	马彦祥	合作
叶少兰	叶盛兰	父母
关悦	佟大为	夫妻
马敬伯	马志明	兄弟姐妹
陈鸣志	王鸣楼	同门
蔡畅	蔡蓉峰	夫妻
太乙真人	九灵元圣	上下级
顺治	孝庄文皇后	父母
汪峰	葛荟婕	情侣
朱孝天	周渝民	合作
左清飞	祝明达	师生
福田康夫	福田贵代子	夫妻
刘整	宋理宗	上下级
吕美荪	吕惠如	兄弟姐妹
魏东	陈金霞	夫妻
何鸿燊	蓝琼缨	夫妻
梁红玉	韩世忠	夫妻
安胜浩	南圭丽	情侣
马岳梁	马江豹	父母
郑伊健	梁咏琪	情侣
朱作舟	尚和玉	师生
刘秉彦	旷伏兆	合作
基德	朱玛娜·基德	夫妻
全公主	全琮	夫妻
陈琪琪	霍思纬	父母
徐子淇	彭雪芳	父母
谢亚龙	南勇	合作
舒马赫	科琳娜	夫妻
李树建	闫长现	师生
张荔英	陈友仁	夫妻
陆雪琪	曾书书	同门
周利	尚慧敏	师生
郭可盈	林文龙	夫妻
黄水泉	黄金山	父母
毛甜懿	毛新宇	父母
管道升	赵孟頫	夫妻
李思阳	陈晓韵	同门
谷开来	谷景生	父母
蒋友青	张心妍	亲戚
六小龄童	章宗义	父母
宋达泉	周昌芸	合作
刘辩	唐姬	夫妻
刘金宝	张德宝	上下级
眭禄	张宇皎	合作
伊万诺维奇	费尔南多·沃达斯科	情侣
邹世龙	何超琼	好友
常宝堃	张寿臣	师生
乔传秀	周国富	情侣
咸丰	孝贞显皇后钮祜禄氏	夫妻
王光美	董洁如	父母
阮大铖	高攀龙	师生
毛利辉元	毛利隆元	父母
黄秋莲	林淑如	亲戚
王世臣	张杰尧	师生
石达开	洪秀全	上下级
谢杏芳	傅汉洵	师生
马景涛	田丽	情侣
蒋方良	蒋经国	夫妻
张苞	张遵	父母
陈镜开	陈满林	兄弟姐妹
谢朝恩	王锡鹏	合作
陈赓	王根英	夫妻
杨盛春	杨铁虎	父母
于会江	赵学义	师生
查尔斯·巴克利	欧文	合作
胡风	梅志	夫妻
张恨水	徐文淑	夫妻
李玉茹	梅兰芳	师生
鲁迅	周伯宜	父母
冯培澜	朱锡昂	师生
小潘潘	黄任中	父母
严化	红薇	夫妻
赵飞燕	赵合德	兄弟姐妹
涂经纬	撒贝宁	情侣
何超贤	何鸿燊	父母
徐光宪	高小霞	夫妻
石小群	尤小刚	合作
王弢	刘璇	夫妻
佐藤久佳	北岛康介	合作
张清芳	宋学仁	夫妻
袁咏仪	张智霖	夫妻
李德钖	周德山	合作
郭美美	郭登峰	父母
唐宁	邓伟杰	夫妻
文千岁	窦庭志	师生
薄熙永	薄一波	父母
手冢国光	大石秀一郎	合作
张增友	张少佐	父母
严慰冰	陆定一	夫妻
成钧	赵启民	合作
薛稷	薛道衡	亲戚
包陪庆	包玉刚	父母
吴炳璋	丁至云	合作
苏童	张艺谋	合作
汉武帝	孝景皇后	父母
鲍文蔚	周作人	师生
金正男	成惠琳	父母
安妮·海瑟薇	凯特·麦高莉	父母
马晨菲	杜锋	夫妻
艾青	艾未未	父母
赵吟秋	郭美金	同门
王怡仁	周杰伦	情侣
杨晓丹	傅艺伟	夫妻
钱似莺	洪叔云	亲戚
陈布达	陈佩斯	兄弟姐妹
薛宝钗	王夫人	亲戚
何鸿燊	何超仪	父母
吴承瑛	吴云巢	祖孙
叶剑波	陈焕庭	父母
张謇	吴长庆	兄弟姐妹
太平公主	武攸暨	夫妻
马元亮	马富禄	亲戚
程前	王越	夫妻
郭晓玲	初永真	祖孙
许崇清	许锡挥	父母
吕彦直	吕彦深	兄弟姐妹
自来也	三代火影	师生
吴建豪	安七炫	合作
唐玉成	刘忠河	师生
唐英年	郭妤浅	夫妻
劫夫	张俊图	兄弟姐妹
马相伯	朱志尧	亲戚
叶福海	叶忠定	父母
叶挺	叶大鹰	祖孙
白家麟	高庆奎	师生
蔡岳勋	蔡扬名	父母
费翠棠	马潮水	师生
李渊	李建成	父母
金旼贞	李孝贞	合作
高少亭	张世麟	合作
黄炎培	黄方毅	父母
武田胜赖	仁科盛信	兄弟姐妹
裘芸	于克淼	师生
荀令香	荀慧生	父母
陈鹤峰	周信芳	师生
曹髦	曹霖	父母
顾颉刚	吴征兰	夫妻
吕雉	吕产	亲戚
贺玉钦	王铁侠	合作
朱自清	陈竹隐	夫妻
严庆龄	吴舜文	夫妻
吴昕	张远	情侣
那英	孟桐	夫妻
李炳辰	关锦鹏	师生
王个簃	诸乐三	好友
吴京	吴彬	师生
杨嘉源	大枝雄介	师生
陈奕迅	陈裘大	父母
黄昆	黄子通	亲戚
马大猷	吴大猷	师生
焦裕禄	焦国庆	父母
孙穗芳	王祖耀	父母
谭其骧	葛剑雄	师生
童慧荃	李慧娟	夫妻
成钧	张云逸	合作
唐禾香	杜近芳	师生
大乔	孙权	亲戚
李树建	孙海涛	师生
骆应钧	骆友梅	兄弟姐妹
慕容暐	慕容泓	兄弟姐妹
小泽征尔	伯恩斯坦	师生
池尚昱	沈银河	夫妻
于素秋	成龙	兄弟姐妹
谢逊	成昆	师生
杨思琦	李泳豪	情侣
钟楚红	朱家鼎	夫妻
朱安婕	邢峰	父母
孔令侃	宋子文	亲戚
张成泽	金敬姬	夫妻
英琪	英达	兄弟姐妹
南兴烈	南勇	父母
马晨菲	姚颖	父母
毛泽东	毛顺生	父母
凯特·米德尔顿	威廉王子	夫妻
汪嵩	曾美娟	情侣
谢晖	胡德华	师生
谢晖	徐根宝	师生
金仲仁	王维筠	师生
崔兰田	贾锁	师生
岩井俊二	筱田升	合作
吴作人	萧淑芳	夫妻
刘滨	毛新宇	夫妻
章伯钧	章诒和	父母
孙丽雅	齐秦	夫妻
张立媛	王小蓉	师生
萧军	萧红	夫妻
余紫云	余胜荪	父母
眭禄	杨伊琳	合作
江世俊	江石溪	父母
刘锡明	张齐玲	夫妻
朱文英	朱小喜	父母
张慕童	袁咏仪	父母
陶阳	郭德纲	父母
慕容宝	慕容元	父母
李戡	王小屯	父母
何猷启	何鸿燊	父母
艾青	艾清明	父母
刘亚楼	翟云英	夫妻
杜婧	宋庆华	师生
查传诗	金庸	父母
李显龙	黄名扬	夫妻
贺顺定	郑怀贤	师生
约翰·列侬	小野洋子	夫妻
章含之	洪晃	父母
钟少珍	胡佳	师生
查传诗	赵国安	夫妻
张默	罗秀春	父母
陈玉成	陈得才	合作
马星耀	梁冠华	合作
侯耀华	侯军	父母
钱金福	刘砚亭	师生
范姜	钟镇涛	情侣
叶圣陶	胡墨林	夫妻
释迦牟尼	净饭王	父母
杨洪基	刘文玫	夫妻
妮可·基德曼	汤姆·克鲁斯	夫妻
敖幼祥	李思阳	师生
张正芬	庾澄庆	父母
李世民	李元霸	兄弟姐妹
林青霞	邢爱林	父母
王玉	宋德全	合作
李光耀	李玮玲	父母
筱高雪樵	高雪樵	亲戚
曹丕	曹髦	祖孙
余玠	宋理宗	上下级
鲁元公主	刘邦	父母
梅巧玲	梅兰芳	祖孙
孙莹莹	孙道存	父母
曹睿	曹植	亲戚
任泉	李冰冰	好友
艾青	张竹茹	夫妻
蔡万春	蔡辰男	父母
姜夔	辛弃疾	好友
斯内德	约兰特	夫妻
肯尼迪	帕特里克·布维尔·肯尼迪	父母
霍启刚	卢恬儿	情侣
时慧宝	魏匏公	师生
金旼贞	河贞恩	合作
红孩	李淑晶	合作
邱嘉雄	蔡贵照	夫妻
陈寅	刘海涛	师生
诸邑公主	卫长公主	兄弟姐妹
史润强	李凤兰	师生
少女时代	林允儿	合作
刘滨	毛甜懿	父母
梁锦松	梁皓嘉	父母
爱因斯坦	伯恩哈德·凯撒·爱因斯坦	祖孙
刘文步	郑福山	合作
赵一楠	赵一涵	兄弟姐妹
甄子丹	麦宝婵	父母
周海媚	吕良伟	夫妻
王雪涛	徐佩蕸	夫妻
李心洁	张艾嘉	师生
孙和	孙谦	父母
李金鸿	史敏	师生
杜锋	马晨菲	夫妻
毕淑敏	芦淼	父母
秦昭襄王	秦孝文王	父母
傅子恩	张秋芳	父母
马景涛	马世天	父母
杜月笙	杜文卿	父母
李英	朱巧云	师生
陈冠希	陈泽民	父母
李安琦	文佳	父母
熊景斌	江钰源	师生
六小龄童	闫怀礼	好友
容星桥	容应萸	祖孙
张治中	张一纯	父母
贾南风	贾充	父母
曹操	曹丕	父母
陈华癸	汤佩松	师生
王老赏	周瑶	师生
佟有为	于宝林	师生
李艳芳	傅全香	合作
周亚夫	周勃	父母
王阳	张铎	同门
蒋孝刚	邱爱伦	父母
周萌萌	周瑞新	父母
吴英华	马岳梁	夫妻
扎克伯格	兰迪·扎克伯格	兄弟姐妹
胡斐	苗若兰	情侣
孙壾	孙休	父母
李兆会	李海仓	父母
唐肃宗	唐代宗	父母
程颐	司马光	合作
范镇钰	班德贵	师生
张美娟	周萍	师生
苻坚	苻诜	父母
李敖	胡茵梦	夫妻
梁欢	英如镝	父母
于俊波	焦德海	师生
王贞仪	王锡琛	父母
王玉珍	周麟阁	同门
宋承宪	成宥利	情侣
严凯泰	陈莉莲	夫妻
王凤	王龙兴	父母
柴进	柴荣	祖孙
利智	李连杰	夫妻
戴安娜王妃	多迪·法耶兹	情侣
钱钟书	钱孙卿	亲戚
周迅	朴树	情侣
周良洛	鲁小丹	夫妻
张庆林	曹贵康	合作
孙鲁育	孙亮	兄弟姐妹
马国毕	谢依纯	情侣
依田纪基	安藤武夫	师生
黄宗英	程述尧	夫妻
马三立	连笑昆	师生
粟裕	刘伯承	合作
王军霞	马俊仁	师生
赵忠祥	赵方	父母
关肃霜	徐敏初	合作
王大珩	顾又芬	夫妻
邵华	毛岸英	兄弟姐妹
蜡笔小新	野原广志	父母
马景涛	马世媛	父母
熊明霞	熊昌驹	父母
戴天民	郑泉水	师生
张作霖	张学森	父母
路飞	香吉士	合作
魏文亮	魏文华	兄弟姐妹
木谷实	赵治勋	师生
马奎斯·丹尼尔斯	拉里·伯德	上下级
何甘棠	李海泉	父母
章小蕙	钟镇涛	夫妻
曾江	邓拱璧	夫妻
常宝霆	常宝华	兄弟姐妹
白全福	张伯勋	师生
汤淼	沈琼	合作
金正哲	金正日	父母
梅加瓦蒂	苏卡诺	父母
宋云娜	大多亮	情侣
文震孟	姚希孟	亲戚
卞学鐄	杨步伟	父母
尚小云	尚长麟	父母
浦克	张静	夫妻
慕容皝	慕容汗	兄弟姐妹
顾长卫	蒋雯娟	兄弟姐妹
朱卫茵	李宗盛	夫妻
蔡瑶铣	马树铭	夫妻
乔布斯	阿卜杜法塔赫·约翰·钱德里	父母
小红	林之孝	父母
富坚义博	武内直子	夫妻
龚雪	张迅	夫妻
王又曾	王事展	兄弟姐妹
俞菊笙	俞振庭	父母
何鸿燊	何婉婉	兄弟姐妹
蒋怡	翁狄森	夫妻
杨海荃	周印金	师生
甄家平	甄妮	父母
阿尔比奥尔	阿尔比奥尔	合作
泰戈尔	徐志摩	好友
鲁伯特·默多克	邓文迪	夫妻
林百欣	林建岳	父母
邢嘉倩	张天爱	父母
徐天红	张桂莲	合作
廖承志	廖仲恺	父母
陈汉典	蔡康永	合作
郑太顺	叶欣荣	师生
冯玉祥	冯晓达	父母
李月清	李兆熊	父母
马伟豪	陈慧茵	夫妻
高力士	高延福	父母
宋楚瑜	宋达	父母
梁思宁	梁启超	父母
蒋雯娟	顾长卫	兄弟姐妹
白崇禧	白崇伦	兄弟姐妹
钱玄同	崔适	好友
唐德宗	昭德皇后王氏	夫妻
彭帅	郑洁	合作
周蜜	胡洁	夫妻
陈鹤年	陈祯祥	父母
刘协	董太后	父母
刘德海	林石城	师生
陈英杰	韩雨芹	夫妻
徐悲鸿	徐伯阳	父母
加藤高明	藩士服部重文之	父母
刘淑芳	方贤旭	夫妻
刘志祥	刘志军	兄弟姐妹
林珊珊	罗明珠	合作
陈景润	由昆	夫妻
戴宗	吴用	好友
钟少珍	林跃	师生
黄侃	黄绍兰	夫妻
马步芳	马步青	兄弟姐妹
陈云凤	夏时济	父母
梵高	泰奥多勒斯·梵高	父母
林立衡	叶群	父母
何泽慧	钱思进	父母
冯跋	宋夫人	夫妻
杨洁篪	乐爱妹	夫妻
王濛	周洋	合作
陈冠希	杨永晴	情侣
李东国	李秀珍	夫妻
郑敏	穆旦	好友
蔡尚思	蔡元培	师生
金恩忠	杨德山	师生
秦怡	金捷	父母
余文乐	杨丞琳	情侣
于台烟	梁弘志	师生
Einstein	Einstein	祖孙
董笑笑	张微	父母
俞振飞	言慧珠	夫妻
张柏芝	谢贤	父母
Selina	张承中	情侣
张天翼	契萌	夫妻
阿姆斯特朗	埃里克	父母
冯巩	王谦祥	同门
郑亚旗	郑渊洁	父母
鲁迅	周璟馨	祖孙
甄妮	甄家平	父母
迟浩田	姜青萍	夫妻
傅斯年	傅以渐	亲戚
王君安	尹桂芳	师生
杨之华	沈剑龙	夫妻
慕容宝	慕容垂	父母
蒋百里	左梅	夫妻
李琳	王小利	夫妻
杨亚洲	杨博	父母
陈致中	陈水扁	父母
金圣爱	金平日	父母
奎胜城	刘胜常	同门
胡适	江冬秀	夫妻
托勒密二世	阿西诺亚一世	夫妻
赖昌星	赖文峰	亲戚
海德里希	海因茨	合作
乔·布莱恩特	科比·布莱恩特	父母
洪智	何静	夫妻
韩布新	黄河清	师生
袁和平	甄子丹	师生
鲍蕾	鲍莉	兄弟姐妹
慈少泉	慈瑞泉	父母
王茂源	林世海	师生
田中角荣	女	父母
李维嘉	谢娜	好友
刘海粟	夏伊乔	夫妻
张译	钱琳琳	夫妻
田震	田野	兄弟姐妹
盖叫天	李慧	夫妻
富兰克林	本杰明	祖孙
程知节	程知节	合作
张闾蘅	张学良	亲戚
何念慈	田力行	夫妻
元春	贾政	父母
李亚红	易建联	情侣
杜勤兰	莫言	夫妻
郑伦境	郑进一	父母
桑振君	陈素真	同门
大杨扬	王春露	合作
沉樱	马彦祥	夫妻
李戡	李敖	父母
朱双喜	范芷湘	师生
萧乾	文洁若	夫妻
阿尔法	阿尔斯兰	父母
黄兴	廖淡如	夫妻
毛阿敏	张勇	情侣
陶阳	陶国平	父母
侯耀文	石富宽	合作
沉樱	梁宗岱	夫妻
马步芳	马麒	父母
杨不悔	杨逍	父母
于云霆	于谦	父母
李作鹏	董其采	夫妻
柯玉芝	李光耀	夫妻
陈叔宝	张丽华	夫妻
孙立	栾廷玉	同门
苏哈托	茜蒂·哈蒂娜	夫妻
康康	康孔秀花	父母
葛优	赵晨浩	好友
罗便臣	尼亚	夫妻
战殊	苏西莲	父母
成钧	贺龙	合作
胡雪岩	王有龄	好友
何超琼	何鸿燊	父母
卢彦勋	钱琼文	情侣
张天翼	沈承宽	夫妻
雪梨	米雪	兄弟姐妹
作家张爱玲	张佩纶	祖孙
唐禾香	孙毓敏	师生
约翰·昆西·亚当斯	露易莎·凯瑟琳·约翰逊	夫妻
蒋友柏	蒋友常	兄弟姐妹
鲁迅	羽太信子	兄弟姐妹
夏培肃	杨立铭	夫妻
秦始皇	秦庄襄王	父母
吴璘	吴玠	兄弟姐妹
曹真	曹爽	父母
刘备	刘理	父母
林长民	梁思成	父母
许平君	许广汉	父母
三浦友和	山口百惠	夫妻
章小蕙	章小婉	兄弟姐妹
任远	梁玉洁	夫妻
奚培民	孙正阳	师生
徐熙媛	陈建州	好友
周海婴	周宁	父母
买红妹	孙楠	夫妻
赵无极	谢景兰	夫妻
潘楚颖	杨敏德	父母
黄敬	俞珊	兄弟姐妹
太平公主	唐高宗	父母
秦凯	王峰	合作
冯思语	徐帆	父母
德川家康	筑山殿	夫妻
陈济棠	陈树柏	父母
何静	高大林	夫妻
阎立品	新凤霞	同门
沙孟海	沙文威	兄弟姐妹
孙振泉	孙甫亭	父母
木村拓哉	工藤静香	夫妻
王志文	陈坚红	夫妻
吕瑞英	张咏梅	师生
李鸿章	李瀚章	兄弟姐妹
莫文骅	张云逸	合作
田佳	郑鸿湧	夫妻
允浩	韩庚	好友
徐静斐	蒋碧微	父母
廖凤舒	陈纳德	祖孙
陈丽洁	陈青远	父母
肯尼迪	爱德华·肯尼迪	兄弟姐妹
滨崎步	野村义男	好友
小白玉霜	刘萍	师生
包飞	江世玉	师生
李远哲	李泽藩	父母
林彪	林立衡	父母
爱德华一世	亨利	父母
孙道存	廖镇汉	父母
薛世恒	陈法拉	情侣
袁世凯	袁克文	父母
刘亚男	郎平	师生
陆定一	陆德	父母
贾宝玉	薛宝钗	夫妻
叶在馥	杨槱	师生
卫长公主	刘据	兄弟姐妹
郭羡妮	朱少杰	夫妻
许世友	雷明珍	夫妻
郑进一	郑俊明	兄弟姐妹
安舒元	贵俊卿	师生
罗宝文	罗旭瑞	父母
彦涵	江丰	合作
郭睿玥	张正芳	师生
吕雉	刘盈	父母
果素瑛	程永光	父母
王世臣	赵玉贵	合作
姜一郎	桑德林	父母
荀彧	程昱	合作
威廉·戈尔丁	艾利克·戈尔丁	父母
黄绍竑	龙云	好友
宗毓华	马碧兰	父母
陈永正	大卫·斯特恩	上下级
陈素珍	陈育明	师生
伍迪·哈里森	劳拉·路易	夫妻
彭于晏	蔡依林	情侣
高峰	范春玲	夫妻
郭德纲	胡中惠	夫妻
孙莹莹	张汉扬	夫妻
林立果	林彪	父母
莫声谷	宋远桥	同门
林海峰	吴清源	师生
林育英	林育南	兄弟姐妹
万梓良	恬妞	夫妻
唐寅	沈九娘	夫妻
范斌	阿的江	合作
王明贞	王季同	父母
李婉钰	庹宗康	情侣
敖嘉年	冼灏英	同门
郭羡妮	陶大宇	情侣
骆耀	梁相	同门
马秋仙	郭兰英	合作
童葆苓	马彦祥	夫妻
法布雷加斯	卡拉	情侣
廖烈文	廖宝珊	父母
阮经天	许玮宁	情侣
陈鸿喜	吴顺林	父母
李富春	蔡畅	夫妻
珍妮佛·安妮斯顿	布拉德·皮特	夫妻
冯巩	马季	师生
杨赤	袁世海	师生
莫言	管谟欣	兄弟姐妹
孙尚香	刘备	夫妻
陈小旺	陈发科	祖孙
赵一涵	赵本山	父母
秦怡	陈天国	夫妻
施桂林	施传镇	父母
黄奕	姜凯	夫妻
张克帆	于佳卉	情侣
王狗儿	刘姥姥	父母
焦裕禄	焦跃进	父母
慕容德	慕容超	亲戚
吴鉴泉	吴全佑	父母
倪桂珍	宋美龄	父母
光良	江美琪	情侣
虢国夫人	杨国忠	兄弟姐妹
彼得·克劳奇	阿比·克兰茜	夫妻
蒋中正	宋美龄	夫妻
陶虹	徐峥	夫妻
张会	孙琳琳	合作
郝邵文	释小龙	合作
孙柏龄	月明珠	父母
本多忠胜	本多忠高	父母
佟有为	袁梅君	夫妻
马克昌	曹智慧	夫妻
齐白石	齐良迟	父母
李沛文	苏美霞	合作
格罗弗·克利夫兰	埃丝特·克利夫兰·博赞科特	父母
黎洪模	徐悲鸿	父母
乐珈彤	朱锐	夫妻
董洁	潘粤明	夫妻
李再雯	白玉霜	父母
付小芳	张树春	师生
慕容超	慕容皝	祖孙
孙中山	孙科	父母
马诚方	马恩禄	父母
王德显	朱凤玲	夫妻
千里驹	区星朝	父母
陈毅	陈丹淮	父母
孙仁玉	李桐轩	合作
金正男	金正日	父母
玛丽·盖茨	比尔·盖茨	父母
雪梨	徐伟栋	父母
曹训	曹羲	兄弟姐妹
戴安娜	詹姆斯·休伊特	情侣
钱三强	钱伟长	合作
房祖名	薛凯琪	情侣
黄旭	范雯	夫妻
苏芮	刘威麟	夫妻
陶伟	吕丽萍	夫妻
穆巴拉克	贾迈勒·穆巴拉克	父母
唐闻生	唐明照	父母
尚小云	尚长春	父母
金庸	林乐怡	夫妻
赵燕侠	诸茹香	师生
李杲	张元素	师生
孙骁骁	李响	情侣
蔡瑶铣	方传芸	师生
孙明珠	孟鸿茂	合作
萨科齐	塞西莉亚	夫妻
时小福	陈德霖	父母
奥兰多	米兰达·可儿	夫妻
宋江	宋清	兄弟姐妹
尔东升	尔光	父母
叶童	陈国熹	夫妻
钱煦	胡匡政	夫妻
科比·布莱恩特	乔·布莱恩特	父母
胡兵	瞿颖	情侣
尤金·塞尔南	托马斯·斯塔福德	合作
黄月英	诸葛瞻	父母
秦良玉	马祥麟	父母
松赞干布	文成公主	夫妻
胡蝶	林雪怀	情侣
王茂俊	王弢	父母
言菊朋	言慧珠	父母
朱少杰	郭羡妮	夫妻
陆一婵	叶飞	夫妻
方楚雄	王兰若	师生
洪荣宏	洪一峰	父母
孙鲁育	朱损	父母
李进良	胡瓜	父母
任达华	琦琦	夫妻
叔本华	海因里希·弗洛里斯·叔本华	父母
陆子艺	林妙可	好友
赵培鑫	魏莲芳	合作
鲍吉祥	李宗义	师生
马介璋	蔡加敏	父母
谢智	尹文举	师生
王小列	李琳	夫妻
薛伟森	谢晓虹	父母
陈垣	胡适	同门
张亚东	窦颖	夫妻
霍英东	霍启刚	祖孙
韩增祥	李万春	师生
王处一	王重阳	师生
吴楚帆	高鲁泉	兄弟姐妹
韦德	加布里埃拉·尤尼恩	夫妻
唐代宗	李适	父母
罗小奎	罗福山	祖孙
王新亭	徐向前	合作
马海生	黄韵玲	情侣
元春	王夫人	父母
陈婉珍	何超莲	父母
甄洛	曹丕	夫妻
曹仁	曹操	上下级
徐根宝	谢晖	师生
裘桂仙	徐立棠	师生
胡恩勇	肖燕娟	夫妻
程君谋	程之	父母
萧红	端木蕻良	夫妻
陈独秀	陈乔年	父母
孙琳琳	刘秋宏	合作
陈镜开	陈枝	兄弟姐妹
吴平	陈凌霞	夫妻
吴大观	华允娥	夫妻
宋祖英	宋佳玲	兄弟姐妹
曾肇	宋哲宗	上下级
巩俐	赵英	父母
陈楚河	陈乔恩	情侣
张謇	袁世凯	好友
许海峰	陶璐娜	师生
何桂山	刘永春	师生
杨虎城	杨拯中	父母
马潮水	卫梅朵	合作
程昱	郭嘉	合作
贾雨村	娇杏	夫妻
蒲生氏乡	蒲生贤秀	父母
华佗	治化长老	师生
李艳芳	筱丹桂	合作
刘庭羽	郜林	情侣
张懋森	文平	夫妻
王熙凤	贾琏	夫妻
傅小石	傅二石	兄弟姐妹
黄文迪	吕慧仪	夫妻
瞿颖	李亚鹏	情侣
李香君	侯方域	夫妻
洪秀全	杨秀清	上下级
谭元寿	谭富英	父母
查尔斯	卡米拉	夫妻
周建安	李歌	夫妻
陈小鲁	陈毅	父母
马葭	李亚鹏	好友
刘恺威	杨幂	夫妻
刘庄	阴丽华	父母
王朔	徐静蕾	情侣
林丹	谢杏芳	夫妻
陈山聪	Ponny	夫妻
陆九渊	陆九韶	兄弟姐妹
魏骏杰	张利华	夫妻
唐肃宗	李佖	父母
费贞绫	费玉清	兄弟姐妹
柳德米拉·普京娜	普京	夫妻
戚烈云	戚家汉	父母
韦小宝	建宁公主	夫妻
叶世长	萧长华	师生
蒋经国	毛福梅	父母
程霖生	程谨轩	父母
粟戎生	粟裕	父母
毛利兰	毛利小五郎	父母
施鸿鄂	朱逢博	夫妻
姜夔	范成大	好友
阿奴	李忆如	合作
马英九	周美青	夫妻
戚雅仙	傅幸文	师生
郑经	郑克塽	父母
姚晨	凌潇肃	夫妻
代善	褚英	兄弟姐妹
黄子容	郭守正	夫妻
田荫亭	田士杰	父母
孟小冬	杜月笙	夫妻
金少梅	马少山	夫妻
吕光	吕婆楼	父母
冯默风	陆乘风	同门
孔令侃	宋美龄	亲戚
王大治	戴露	夫妻
王昌虎	王云泉	祖孙
图坦卡蒙	安克姗海娜曼	夫妻
林青霞	秦汉	情侣
唐义贞	陆定一	夫妻
佐勒菲卡尔·阿里·布托	扎尔达里	父母
戴克明	戴克林	兄弟姐妹
于立群	郭世英	父母
Jordan	詹姆斯·乔丹	父母
英若诚	蔡葆真	父母
陈红	陈永才	父母
宋子文	张乐怡	夫妻
郑桂云	张玉斌	夫妻
程昱	邢贞	合作
程小青	程育真	父母
孙匡	孙翊	兄弟姐妹
谷景生	范承秀	夫妻
霍震寰	霍英东	父母
沈葆桢	林普晴	夫妻
宋丹丹	英巴图	父母
邢夫人	贾琮	父母
田鹏飞	伍文忠	师生
贺捷生	蹇先任	父母
奚啸伯	李伯培	师生
黄一一	黄秋生	父母
王保保	察罕帖木儿	亲戚
周侗	宗泽	好友
宋濂	贾专	夫妻
黄铁良	何德利	合作
杨博森	杨燕毅	师生
姜妙香	闫庆林	师生
赵岭	袁立	夫妻
潘文复	田慧棣	夫妻
甄子丹	汪诗诗	夫妻
金东文	河泰权	合作
朱时茂	陈佩斯	合作
丁绪贤	丁光生	父母
何音	黄渤远	父母
曹露双	小玉霜	师生
张家霈	康康	夫妻
曹据	曹冲	兄弟姐妹
小S	许庆祥	父母
陈秀雯	林国雄	夫妻
李亚力	李正源	父母
傅彪	傅子恩	父母
邓肇坚	冯锦美	夫妻
顾颉刚	顾潮	父母
单田芳	单永魁	父母
魏宁	魏善斋	父母
王绍伟	5566	合作
杨永晴	陈冠希	情侣
唐高祖	唐太宗	父母
冯刚毅	王玉珍	师生
令狐冲	任我行	父母
骆莉娜	孙兴	夫妻
夏衍	巴金	好友
陈独秀	陈延年	父母
聂卫平	孔祥明	夫妻
李思阳	陈诺	同门
尤颖钦	刘乐仪	父母
魏文亮	武魁海	师生
朱德	朱敏	父母
铫期	邓禹	合作
勘九郎	手鞠	兄弟姐妹
陈果夫	陈其美	亲戚
陆川	秦岚	情侣
张恨水	胡秋霞	夫妻
康盘石	金日成	父母
辛迪·克劳馥	Jordan	父母
刘胡兰	胡文秀	父母
方青卓	沈小萌	夫妻
连胜文	连定捷	父母
猪哥亮	倪敏然	合作
李菁	梁厚民	师生
唐天际	刘伯承	合作
潘金莲	西门庆	情侣
高宝贤	马长礼	师生
丰臣秀吉	木下弥右卫门	父母
林子萱	杨正	夫妻
许连捷	许书典	父母
区文诗	铃木仁	情侣
曹敏莉	于树基	情侣
张馨予	李晨	情侣
约翰·施特劳斯	约翰·施特劳斯	父母
陈良发	魏燕鹏	上下级
李寿山	李菊笙	父母
付洋	傅亮	兄弟姐妹
张松山	黄维敏	父母
韩凤英	厉慧森	父母
郝兰田	王瑶卿	祖孙
佐藤信二	佐藤荣作	父母
徐静斐	黎枫	父母
周汤豪	蔡依林	同门
陈小旺	陈照奎	亲戚
吴宇森	吴飞霞	父母
魏春芳	章益清	合作
关山月	高剑父	师生
费孝通	费振东	兄弟姐妹
孔子	漆雕开	师生
何鸿燊	何婉琪	兄弟姐妹
Chara	浅野忠信	夫妻
陈绍基	蒋文端	情侣
戈宝权	梁培兰	夫妻
郭松龄	韩淑秀	夫妻
阎维文	李禾禾	父母
石达开	韦昌辉	合作
李杲	王好古	师生
张紫仙	张连福	父母
章士钊	奚翠贞	夫妻
岸边成雄	田坂兴道	同门
周星驰	周星霞	兄弟姐妹
陆雪琪	水月	师生
阮玲玉	张达民	夫妻
凯尔·巴特利	克雷格·伊斯特蒙德	合作
李继迁	李光俨	父母
傅丽莉	孙淳	夫妻
金秀山	金少山	父母
许冠文	许冠武	兄弟姐妹
张默	张国立	父母
徐玉兰	施银花	合作
王吟秋	程砚秋	师生
苗立杰	卞兰	合作
李环春	李桐春	合作
关颖	朱志威	夫妻
李兆基	李兆楠	兄弟姐妹
胡宝善	王亦满	夫妻
孙芸芸	廖伟志	父母
陈凯歌	陈怀皑	父母
吴镇宇	刘青云	好友
柳亚子	柳无忌	父母
张灵甫	张居礼	父母
王淑贞	倪葆春	夫妻
倪匡	亦舒	兄弟姐妹
左小祖咒	艾未未	好友
姜文	姜武	兄弟姐妹
倪萍	郭达	情侣
允浩	赵晨浩	好友
彭壮壮	易小准	亲戚
白土三平	冈本唐贵	父母
傅声	甄妮	夫妻
撒切尔	丹尼士•撒切尔	夫妻
任讷	于子恒	父母
张纪中	樊馨蔓	夫妻
吕碧城	吕凤歧	父母
张舒雅	李亚男	同门
金喜善	朴周永	夫妻
罗继祖	罗振玉	祖孙
许崇智	许崇清	兄弟姐妹
刘政会	程知节	合作
王姬	高峰	夫妻
孔令谦	孔少华	父母
张辽	关羽	好友
李斯忠	兰力	师生
刘銮雄	甘比	情侣
艾青	艾端午	父母
沈丰英	张继青	师生
侯少奎	侯爽	父母
谢晋	谢佳庆	父母
徐子淇	洪天明	情侣
付洋	张洁清	父母
杜鲁门	约翰·安德森·杜鲁门	父母
胡世华	胡惟德	父母
赵伟洲	李嘉存	合作
段延庆	段誉	父母
郑小龙	郑月霞	父母
高小英	张东健	夫妻
周有光	张允和	夫妻
裘英俊	姜宝林	师生
麦当娜	西恩·潘	夫妻
刘孜	杨泓	夫妻
徐邦达	吴湖帆	合作
撒切尔	卡洛儿	父母
郭全宝	郝爱民	合作
海德里希	伊丽沙白	父母
萧芳芳	萧乃震	父母
王靖雄	张艾嘉	夫妻
张云标	相来炳	师生
哈维·阿隆索	哈维	合作
傅全香	孙琴文	父母
陈巨来	赵叔孺	师生
蒋介石	毛福梅	夫妻
孔子	亓官氏	夫妻
冯玉祥	冯理达	父母
王弢	马明宇	好友
夏宇童	黄子佼	夫妻
郑幸娟	郑庆香	父母
肖邦	乔治·桑	情侣
唐伯虎	沈九娘	夫妻
陈大愚	陈佩斯	父母
尚慧敏	李喜鸿	师生
周采芹	裘丽琳	父母
马师曾	红线女	夫妻
钱仲联	翁端恩	祖孙
巴克利	欧文	合作
侯长山	侯长松	兄弟姐妹
李贤义	晏紫	父母
孙鲁育	朱据	夫妻
森高千里	江口洋介	夫妻
麻生太郎	麻生信子	兄弟姐妹
吉粉花	刘学根	夫妻
雷英	林玉梅	师生
沈星培	李春泉	师生
巩俐	黄和祥	夫妻
高育仁	高思博	父母
蒋慕萍	蒋遂平	父母
梁静茹	赵元同	夫妻
李昭	胡耀邦	夫妻
普希金	果戈理	好友
郑钧	刘芸	夫妻
陶希圣	萨孟武	同门
刘开渠	程丽娜	夫妻
大黑摩季	A君	夫妻
秋瑾	王子芳	夫妻
宋蔼龄	孙中山	兄弟姐妹
孙匡	曹操	兄弟姐妹
卞学鐄	赵元任	父母
薛宝钗	史湘云	好友
王瑾	段奕宏	夫妻
熊明霞	孙毓敏	师生
夫差	伍子胥	上下级
毕春芳	戚雅仙	合作
买红妹	买宝瑶	父母
博尔特	Bolt	亲戚
黎健图	黎洪模	父母
汪涵	林菁	夫妻
英千里	蔡儒楷	父母
丁是娥	丁婉娥	师生
曾山	曾炳生	兄弟姐妹
鲁迅	许广平	夫妻
郭荣启	杨少华	师生
任重	王阳	同门
陈颖	张志敏	父母
管同	姚鼐	师生
张翠山	张三丰	师生
李世民	唐高祖	父母
让·保罗·萨特	阿尔贝·加缪	好友
张雨生	张惠妹	好友
周瑜	孙权	上下级
常宝霆	常贵田	亲戚
卫子夫	刘据	父母
诸葛亮	诸葛珪	父母
洪秀全	石达开	上下级
葛优	贺聪	夫妻
施瓦辛格	米尔德丽德·帕特里夏·巴埃纳	情侣
成龙	于素秋	兄弟姐妹
唐玉成	朱勤堂	师生
何猷启	何超莲	兄弟姐妹
彭家元	王菊逸	夫妻
撒切尔	马克	父母
张素我	张治中	父母
薛蟠	薛姨妈	父母
陈鹤年	陈松年	兄弟姐妹
麦嘉轩	张国荣	亲戚
严慰冰	陆瑞君	父母
十六夜	犬大将	夫妻
刘喜奎	崔承炽	夫妻
杨振宁	翁帆	夫妻
李艳芳	姚水娟	合作
田荫亭	田蕴章	父母
罗雪娟	罗国安	父母
田卿	沈烨	情侣
喻传海	张荣标	师生
俞明震	俞明颐	兄弟姐妹
李鸿章	张佩纶	父母
李维嘉	何炅	好友
巩汉林	赵丽蓉	父母
林心如	赵薇	好友
高秀敏	何庆魁	夫妻
常宝华	常连安	父母
王明	王丹芝	父母
车晓	王丽云	父母
上官婉儿	武三思	情侣
陈婉珍	何超云	父母
海德里希	希特勒	上下级
弗兰克·兰帕德	哈里·雷德克纳普	亲戚
张卫健	宣萱	情侣
宋承宪	宋慧乔	情侣
松本刚明	松本十郎	父母
张卫健	梁汉文	好友
蔡旻纹	林传凯	夫妻
张维	张克澄	父母
顾传玠	张元和	夫妻
周利	刘世翔	师生
俞岱岩	张三丰	师生
苏文茂	常宝堃	师生
王濛	张会	合作
邓爱嘉	邓永锵	父母
麦炳荣	于素秋	夫妻
刘宝全	宋五	师生
申雪	姚滨	师生
刘表	刘琮	父母
木吒	金吒	兄弟姐妹
刘源	刘少奇	父母
白韵琴	谢伟俊	夫妻
况明洁	刘纪军	夫妻
王瑞芝	李佩卿	师生
伍仕贤	龚蓓苾	夫妻
荣毅仁	荣德生	父母
俞扬和	俞大维	父母
关智斌	张敬轩	情侣
蒋孝严	黄美伦	夫妻
兰雨霖	朱泳腾	夫妻
蒋介石	蒋肇聪	父母
Angelababy	黄晓明	情侣
九灵元圣	太乙真人	上下级
鸠山邦夫	鸠山由纪夫	兄弟姐妹
田连章	田连澍	兄弟姐妹
杨钰莹	赖文峰	情侣
李贤义	李圣根	父母
陈佩斯	陈强	父母
王新欣	沈祥福	师生
范紫东	范文豹	父母
张飞	张绍	父母
李尚大	吴灿英	夫妻
李莎	李立三	夫妻
宋丹丹	袁钢	情侣
梅兰芳	梅葆玥	父母
荣德生	荣宗敬	兄弟姐妹
甄士隐	贾雨村	好友
谢晋	谢建庆	父母
钟云香	徐玉兰	同门
后羿	嫦娥	夫妻
贾蓉	秦可卿	夫妻
关羽	关索	父母
舍甫琴科	乔丹	父母
黄炎培	黄培英	兄弟姐妹
冯小刚	冯思语	父母
戴国恒	鲜牡丹	夫妻
廖俊杰	邱胜翊	合作
杨孝亭	吴连奎	师生
刘辩	刘宏	父母
杨步伟	卞学鐄	父母
祝钒刚	祝锵博	兄弟姐妹
冯宝华	侯宝林	合作
秋瑾	秋誉章	兄弟姐妹
左塞尔	赫特弗内布缇	夫妻
薛福成	曾国藩	上下级
克里斯特尔斯	布莱恩·林奇	夫妻
福坪安	董鹤良	师生
夏明衡	陈云凤	父母
塔提亚娜·塔拉索娃	阿列克谢·亚古丁	师生
莫妮卡·贝鲁奇	文森特·卡索	夫妻
许玮伦	李威	情侣
沈括	王安石	师生
陈友仁	张荔英	夫妻
张天爱	王盛德	夫妻
金瑞苗	金荣水	师生
马鹤凌	秦厚修	夫妻
刘永奎	刘贯一	父母
冯宝华	于宝林	合作
嫦娥	后羿	夫妻
元春	贾探春	兄弟姐妹
钟少珍	火亮	师生
王近山	陈赓	合作
贾谊	长沙王	师生
金正日	高英姬	夫妻
宋清	宋江	兄弟姐妹
俞菊笙	俞步兰	祖孙
何鸿燊	黎婉华	夫妻
何超莲	陈婉珍	父母
彭壮壮	易小冶	父母
白歆惠	郑元畅	好友
石原裕次郎	石原慎太郎	兄弟姐妹
何泽慧	钱三强	夫妻
戴军	卢中强	合作
罗尔纲	陈婉芬	夫妻
宋蔼龄	宋庆龄	兄弟姐妹
千百惠	高大林	夫妻
小泉纯一郎	小泉信子	兄弟姐妹
钱妙花	袁雪芬	同门
司马懿	曹操	上下级
冯胜	冯国用	兄弟姐妹
龙榆生	黄季刚	师生
琦琦	任晴佳	父母
荀彧	荀绲	父母
陈发科	陈长兴	祖孙
吕晶晶	盛品儒	情侣
傅雷	傅聪	父母
郭德纲	于谦	合作
毕文静	王鹏	夫妻
毛泽东	文七妹	父母
靓元亨	廖侠怀	师生
王予柔	王东生	父母
安室奈美惠	温大	父母
孙科	孙穗芬	父母
霍大顺	霍树棠	祖孙
萧克	萧克允	兄弟姐妹
斡儿答	拔都	兄弟姐妹
阎笑儒	马三立	师生
罗兰·巴特	路易·巴特	父母
康有为	张云珠	夫妻
黑嘉嘉	黑南苹	父母
徐庶	刘备	上下级
焦德海	李寿增	师生
朱嵩松	李佳黛	合作
戴安娜	多迪·法耶兹	情侣
戚雅仙	朱祝芬	师生
李公朴	张曼筠	夫妻
席尔瓦	吉尔伯托	合作
叶问	李小龙	师生
罗美薇	李丽珍	合作
金铁霖	李谷一	夫妻
徐静斐	黎群	父母
冯天薇	王越古	合作
张恩照	张纪纲	父母
严停云	叶明勋	夫妻
田荫亭	田连章	亲戚
陈群	陈寔	父母
李白	李客	父母
关之琳	刘德华	好友
卡卡	鲍斯高·伊泽森·柏莱拉·莱特	父母
吴晗	吴懋环	祖孙
马佩璋	白先诚	父母
彭家元	彭传诚	父母
郭全宝	马季	合作
冯弘	冯爱居	亲戚
郭沫若	郭平英	父母
赵忠尧	郑毓英	夫妻
杨海荃	金炳昶	师生
裘盛戎	裘少戎	父母
王小骞	谭江海	夫妻
汪雨	黄奕	情侣
陈光	史瑞楚	夫妻
徐悲鸿	徐庆平	父母
李心洁	彭顺	夫妻
许戈辉	丁健	夫妻
李隼	张怡宁	师生
赵吟秋	王素君	同门
鲜灵霞	崔连润	师生
蒋孝勇	蒋友青	父母
郑板桥	郑之本	父母
罗大佑	张艾嘉	情侣
陈小鲁	楚青	父母
白先勇	马佩璋	父母
马思聪	马如龙	父母
克林顿	罗杰·克林顿	父母
凤凰女	麦炳荣	合作
陶琪	袁雪芬	师生
周洋	崔顺子	师生
黄奕	黄毅清	情侣
叶一茜	田欣仪	父母
高盛麟	叶盛章	合作
冯异	苗萌	合作
李吉来	刘吉庆	师生
孙甫亭	罗福山	师生
徐天红	赵雅麟	合作
慕容复	慕容博	父母
吴征镒	吴京	父母
拔都	斡儿答	兄弟姐妹
元太宗	贵由	父母
刘涛	王珂	夫妻
王阳	吕一	好友
袁和平	袁祥仁	兄弟姐妹
英若诚	英达	父母
白家麟	李鹤亭	师生
章伯钧	章伯韬	兄弟姐妹
刘雪华	刘德凯	情侣
刘文辉	刘文彩	兄弟姐妹
胡松华	张曼茹	夫妻
窦尔博	梁咏琪	情侣
郭可盈	郭达昌	父母
徐天红	陆锦花	合作
伏羲	女娲	夫妻
半日安	上海妹	夫妻
文千岁	梁少芯	夫妻
李连捷	李庆逵	合作
华雯	秦雷	夫妻
施易男	林心如	情侣
唐杰忠	刘宝瑞	合作
霍震宇	霍震霆	兄弟姐妹
黄兴	程潜	亲戚
唐涤生	薛觉先	兄弟姐妹
林黛	程思远	父母
朱宏钧	白清扬	父母
邓绥	汉和帝	夫妻
李蓉芳	蔡宝华	合作
本庄繁	本庄常右卫门	父母
林风眠	冯叶	父母
霍元甲	霍东阁	父母
焦裕禄	余音	祖孙
毛世来	邢美珠	师生
钱伟长	孔祥瑛	夫妻
林正英	苑琼丹	夫妻
贾兰坡	裴文中	师生
阿尼尔·阿姆巴尼	Munim	夫妻
刘坤龙	蔡康永	情侣
林长民	林徽音	父母
鲁思·克利夫兰	格罗弗·克利夫兰	父母
谢贤	谢婷婷	父母
夏侯楙	清河公主	夫妻
夏金桂	薛蟠	夫妻
赵梓淇	周信希	父母
钱三强	何泽慧	夫妻
周侗	谭正芳	师生
蔡万春	蔡万才	兄弟姐妹
郑进一	何庆清	合作
秦可卿	贾珍	父母
贺子珍	贺敏学	兄弟姐妹
黄俊钦	黄光裕	兄弟姐妹
邝美云	郭台铭	情侣
梁欢	梁左	兄弟姐妹
丘吉尔	伦道夫·丘吉尔	父母
张云溪	袁世海	兄弟姐妹
鄢颇	高圆圆	情侣
高竣熙	魔力少年	合作
刘元彤	梅兰芳	师生
吴石	王碧奎	夫妻
李连捷	侯光炯	合作
曼德拉	温妮	夫妻
张继先	宋徽宗	上下级
谭孝曾	谭鑫培	祖孙
张学良	张作霖	父母
李伯培	奚啸伯	上下级
李公律	周传瑛	师生
石舫亘	黄美伦	父母
明熹宗	明光宗	父母
谌容	梁左	父母
林超群	林小群	父母
吴敦义	吴奚	父母
李喜儿	李宗盛	父母
小室哲哉	吉田麻美	夫妻
庞伟	张广伟	师生
李干成	吕继英	夫妻
杨得志	罗瑞卿	合作
徐伯阳	蒋碧微	父母
伏明霞	梁锦松	夫妻
曹仁	曹楷	父母
谈杨	朱挺	合作
水均益	杨迪	夫妻
铃木园子	京极真	情侣
王蒙	崔瑞芳	夫妻
陈珊珊	陈毅	父母
周建南	周小川	父母
武敦儒	郭破虏	同门
范文澜	戴冠芳	夫妻
蒋介石	蒋纬国	父母
王蕙芳	梅兰芳	同门
花砚茹	周琳	师生
马廷强	黎姿	夫妻
周丽淇	周汶锜	兄弟姐妹
倪桂珍	倪蕴山	父母
邹市明	张传良	师生
叶公超	陈香梅	好友
梅兰芳	梅雨田	亲戚
戚雅仙	尹桂芳	合作
李慧芝	彭帅	合作
谭凤元	程久斋	师生
筱文滨	筱月珍	夫妻
曹棘	刘姬	父母
裘盛戎	孟广禄	师生
斯内德	罗曼娜	夫妻
浦熙修	浦友梧	父母
范志毅	李茏怡	夫妻
裘芸	于国霖	师生
张居正	明神宗	师生
黄秋生	黄一一	父母
汪桂芬	王凤卿	师生
高凤山	曹德奎	父母
王菲	刘嘉玲	好友
不二周助	不二淑子	父母
蹇先任	贺龙	夫妻
郭明义	孙秀英	夫妻
曾宝仪	曾志伟	父母
真田幸村	真田昌幸	父母
董其武	姚勤修	夫妻
黄浩义	周采茨	夫妻
温斯顿·丘吉尔	伦道夫	父母
查尔斯·巴克利	奥拉朱	合作
刘琨	祖逖	好友
曾海生	曾山	父母
李根	李永波	父母
毛利辉元	毛利秀元	父母
福田康夫	福田赳夫	父母
施光南	施复亮	父母
勒布朗·詹姆斯	波什	合作
蒋经国	蒋孝文	父母
钱似莺	洪金宝	祖孙
李秋平	姚明	师生
许杏虎	朱颖	夫妻
罗璇	谢才萍	情侣
刘备	赵云	上下级
戴绮霞	戴凤鸣	父母
艾丽·范宁	达科塔·范宁	兄弟姐妹
左小青	陈道明	情侣
陈赓	傅涯	夫妻
朱德刚	吴兆南	师生
吴京	李连杰	同门
马富禄	金少山	合作
冯慧兰	洪培才	夫妻
赵高	秦始皇	上下级
祖逖	刘琨	好友
陆子艺	蒋依依	好友
王政君	王曼	兄弟姐妹
邬丽珠	任彭年	夫妻
郑家钧	夏明翰	夫妻
王娡	王皃姁	兄弟姐妹
刘思齐	刘谦初	父母
谭凤元	良小楼	合作
靓次伯	雏凤鸣	合作
曹德旺	曹晖	父母
郭靖	郭芙	父母
谢婷婷	谢贤	父母
陈满林	陈镜开	兄弟姐妹
郑欣宜	郑少秋	父母
李健熙	李在镕	父母
李昌镐	李度崘	夫妻
高小霞	徐光宪	夫妻
杨采妮	金城武	情侣
詹姆斯	波什	合作
里皮	西蒙内塔·里皮	夫妻
拿破仑	拿破仑二世	父母
钱伟长	钱三强	合作
郑洁	张宇	夫妻
邵力子	傅学文	夫妻
罗小奎	曹二庚	师生
张洛君	张克帆	合作
玛丽·沃斯通克拉夫特	玛丽	父母
林凤娇	成龙	夫妻
张瑞芳	严励	夫妻
梁启超	梁从诫	祖孙
刘禅	刘琮	父母
周天娜	周信芳	父母
葛洪	鲍靓	父母
黄宗英	黄宗汉	兄弟姐妹
许孟哲	5566	合作
拉姑	谢振轩	祖孙
李泽钜	李嘉诚	父母
黄品冠	梁静茹	好友
马英九	马唯中	父母
惠英红	黄子扬	情侣
宋丹菊	宋德珠	父母
梅雨田	贾祥瑞	师生
查尔斯·林德伯格	阿斯特丽德	父母
郭政鸿	滕丽名	情侣
章汉夫	谢启美	兄弟姐妹
史冬鹏	包又琴	父母
菲利普·因扎吉	西蒙尼·因扎吉	兄弟姐妹
李万春	李圜春	兄弟姐妹
罗美薇	张学友	夫妻
阵内智则	藤原纪香	夫妻
曹宪	曹华	兄弟姐妹
贾珍	秦可卿	父母
陶铸	陶斯亮	父母
马良	马谡	兄弟姐妹
侣皓吉吉	海岩	父母
孙和	孙俊	父母
李敬元	李孝贞	合作
竺基焕	姚水娟	师生
王娡	王仲	父母
王越古	刘国栋	师生
乔治·索罗斯	多美子·博尔顿	夫妻
桑普拉斯	费德勒	好友
徐静琪	白登云	师生
弗洛伊德	鲁西安·弗洛伊德	祖孙
韩乔生	王小峰	好友
满宠	曹操	上下级
虎美玲	刘翠芳	师生
冯亦代	郑安娜	夫妻
徐碧云	醉丽君	师生
荀子	张苍	师生
黄君璧	黄功华	兄弟姐妹
李泽钜	庄月明	父母
王振义	陈竺	师生
陈乔年	陈延年	兄弟姐妹
蔡万春	蔡辰洋	父母
本桥麻里	长谷川久美子	合作
卡斯特罗	达莉亚·索托	夫妻
小筱月珍	筱月珍	父母
郑允浩	韩庚	好友
张国荣	唐鹤德	情侣
韩雪	王力宏	好友
鲁豫	朱雷	夫妻
南宫公主	平阳公主	兄弟姐妹
车杜里	车范根	父母
法布雷加斯	卡尔罗塔·法布雷加斯	兄弟姐妹
小泉纯一郎	小泉隆子	兄弟姐妹
秋桐	贾琏	夫妻
柳如是	钱谦益	夫妻
周迅	窦鹏	情侣
郭德纲	郭麒麟	父母
郎平	白浪	父母
谭孝曾	谭元寿	父母
莎拉波娃	萨沙·武贾西奇	情侣
肖燕娟	胡恩勇	夫妻
释小龙	释永信	师生
莫文骅	张爱萍	合作
黄万里	黄炎培	父母
李静	黄小茂	夫妻
常佩业	马季	师生
毛剑卿	周晶洁	情侣
阿萨法·鲍威尔	斯蒂芬·弗朗西斯	师生
房仕德	成龙	兄弟姐妹
彭梅魁	彭康志	兄弟姐妹
王德泰	杨靖宇	合作
叶挺	叶正明	父母
孙策	孙匡	兄弟姐妹
冯玉祥	刘德贞	夫妻
蒋经国	蒋纬国	兄弟姐妹
罗舜初	静	夫妻
魏文亮	魏巍	父母
申雪	赵宏博	夫妻
马克斯·普朗克	奥托·哈恩	好友
王淑贞	王守武	兄弟姐妹
彭壮壮	江竹筠	祖孙
薄望知	薄熙来	父母
俞珊	俞明震	祖孙
高云翔	董璇	夫妻
陆锦花	夏赛丽	师生
庾澄庆	张正芬	父母
张绍	张飞	父母
裘丽琳	裘仰山	父母
蔡志明	蔡加赞	父母
筱俊亭	小筱俊亭	父母
李砚秀	李新兰	父母
王梦云	李金泉	师生
陆锦娟	沈爱莲	合作
赵丹	赵劲	父母
王小利	赵本山	师生
吴君玉	吴新伯	父母
尼赫鲁	英迪拉·甘地	父母
张国立	邓婕	夫妻
法布雷加斯	法兰西斯克·法布雷加斯	父母
孙和	孙权	父母
班德贵	赵心敏	合作
费麒	罗海琼	夫妻
屠杏花	施银花	合作
慕容皝	慕容俊	父母
刘遵义	麦嘉轩	夫妻
王政君	王贺	祖孙
关之琳	张冰茜	父母
吴季兰	王文清	夫妻
林小群	林超群	父母
黄睿靓	陈洁歆	父母
赵景深	李希同	夫妻
张文霞	刘春慧	师生
张庆鹏	巴特尔	合作
李菁	郭德纲	同门
查尔斯王储	戴安娜	夫妻
李裹儿	武崇训	夫妻
宋逸民	陈维龄	夫妻
郑成功	郑芝龙	父母
孔东梅	孔继宁	兄弟姐妹
王濛	孙琳琳	合作
袁和平	洪金宝	合作
张居正	张懋修	父母
裘丽琳	周采芹	父母
常香玉	王冠君	好友
原田淑人	加藤繁	同门
袁克文	袁世凯	父母
姜凯	黄奕	夫妻
陈云	于若木	夫妻
理雅各	汉娜	夫妻
马清伟	马锦灿	父母
苏珊·穆巴拉克	穆巴拉克	夫妻
郭荣启	马德禄	师生
麦凯恩	道格	父母
司马衷	愍怀太子	父母
谭雪	王敬之	夫妻
霍华德	弗朗西斯	合作
司马懿	吴质	好友
诸葛亮	诸葛乔	父母
金范	金素恩	情侣
石舫亘	蒋万安	夫妻
康康	张家霈	夫妻
关凌	姬云飞	情侣
周星驰	罗凯珊	情侣
张浩锋	张丹峰	父母
蕾哈娜	Brown	情侣
袁滨忠	筱文滨	师生
王洪礼	王亮	父母
郝为真	郝月如	父母
张悬	焦仁和	父母
贾政	林如海	兄弟姐妹
萧绎	萧詧	亲戚
种世衡	种谔	父母
陈静仪	钱景峰	情侣
叶浅予	戴爱莲	夫妻
甘萍	黎兵	夫妻
叶选廉	叶文珊	兄弟姐妹
鲁元公主	张耳	父母
李瑞英	张宇燕	夫妻
李飞龙	马师曾	师生
木谷实	柴野美春	夫妻
张一白	徐静蕾	好友
诸邑公主	石邑公主	兄弟姐妹
慕容皝	慕容昭	兄弟姐妹
刘思齐	邵华	兄弟姐妹
洪君彦	洪晃	父母
术赤	成吉思汗	父母
蒋中正	毛福梅	夫妻
穆巴拉克	阿拉·穆巴拉克	父母
林散之	林成璋	父母
穆桂英	杨六郎	父母
徐天红	戴忠桂	合作
董昭	董访	兄弟姐妹
海德里希	布鲁诺	父母
冼夫人	冯暄	祖孙
李铭顺	范文芳	夫妻
孙之俊	孙燕华	父母
陈大愚	陈强	祖孙
张一	黄光泉	师生
周祖谟	余嘉锡	父母
叶永烈	杨蕙芬	夫妻
宋美龄	倪桂珍	父母
俞步兰	程继先	师生
汪明荃	刘昌华	夫妻
龚澎	龚普生	兄弟姐妹
刘至翰	刘尚谦	父母
许昱华	刘菁	夫妻
王平	李伯祥	师生
胡瓜	胡盈祯	父母
金正恩	李雪主	夫妻
谢东	杨钰莹	情侣
景海鹏	刘伯明	合作
蒋友梅	蒋经国	祖孙
何东	何爱榆	亲戚
谭冠三	李光明	夫妻
叶步青	黄敦梁	同门
左宗棠	咸丰	上下级
梶和为	武宫正树	父母
王秀兰	原筱亭	师生
裘丽琳	周采藻	父母
韩鹏	朱广沪	师生
陈寅恪	陈三立	父母
谢觉哉	王定国	夫妻
陆喜才	陆富来	兄弟姐妹
周佳纳	周天娜	父母
鲍莉	陆毅	兄弟姐妹
阿德尔曼	麦蒂	师生
焦少海	焦德海	父母
傅艺伟	杨晓丹	夫妻
毛人凤	戴笠	上下级
陈之佛	陈修范	父母
周洋	李琰	师生
汉明帝	阴丽华	父母
托塔李天王	巨灵神	上下级
郑振铎	郑尔康	父母
碧昂斯	Jay-Z	夫妻
孙维世	周恩来	父母
张正芳	荀慧生	师生
郑渊洁	郑亚旗	父母
李维汉	金维映	夫妻
韦迪	南勇	情侣
宋逸民	宋承骏	父母
邱议莹	李永得	夫妻
张桂凤	章海灵	师生
猪哥亮	谢金燕	父母
李清照	王氏	父母
张卫健	许志安	好友
王希坚	王翔千	父母
张宇飞	张雨生	兄弟姐妹
童葆苓	童祥苓	兄弟姐妹
公孙胜	蔡京庆	父母
孙道存	何念慈	夫妻
周辅国	阎全德	师生
路三宝	荀慧生	师生
浦熙修	袁子英	夫妻
吕彤羽	吕正操	父母
潘虹	米家山	夫妻
李蓉芳	李世芳	师生
孔祥熙	蒋介石	兄弟姐妹
谭富英	谭孝曾	祖孙
孙穗芳	孙科	父母
孟海	林正英	同门
黄药师	冯默风	师生
梁冶中	梁稳根	父母
郑进一	陈茱莉	夫妻
韩瑜	孙协志	情侣
固伦和孝公主	丰绅殷德	夫妻
罗秀春	张国立	夫妻
陈垣	启功	师生
徐悲鸿	徐芳芳	父母
李隼	郭焱	师生
赵本山	葛淑珍	夫妻
李正敏	高登岳	师生
阚泽良	荣剑尘	师生
张维	张克群	父母
杭天琪	张泽民	夫妻
卢恬儿	卢润森	父母
王映霞	王二南	祖孙
尚慧敏	尚小云	祖孙
萧亚轩	祝钒刚	情侣
刘文步	杨少奎	师生
薛宝钗	夏金桂	兄弟姐妹
张作霖	张学良	父母
张无忌	俞莲舟	师生
梁咏琪	Sergio	夫妻
燕姿	孙燕佳	兄弟姐妹
法比亚诺	卡卡	合作
张煌言	郑成功	合作
田荫亭	田起山	兄弟姐妹
荀彧	荀爽	亲戚
丫蛋	王金龙	夫妻
小泉孝太郎	小泉纯一郎	父母
黄圣依	吴敬琏	亲戚
陈云	陈晓丹	祖孙
陈小津	陈丕显	父母
孙道存	孙法民	父母
曹世才	曹世嘉	兄弟姐妹
张仲景	张伯祖	师生
贾母	贾政	父母
陈化成	道光	上下级
胡宗南	叶霞翟	夫妻
孙立	顾大嫂	兄弟姐妹
李裹儿	李显	父母
伍兹	杰米·格拉布斯	情侣
陈连仲	范伟	师生
何雯娜	卓贤麟	师生
周利	沈世华	师生
陈晓旭	姬玉	好友
陈金雀	陈连儿	父母
赵南哲	赵治勋	亲戚
金筱邦	金荣水	亲戚
谷开来	薄熙来	夫妻
张灵甫	王玉龄	夫妻
余德琳	许志安	情侣
林峰	何超云	情侣
董浩	董笑笑	父母
小林光一	木谷实	师生
拉斐尔·达席尔瓦	法比奥·达席尔瓦	兄弟姐妹
鲁尼	娜塔丽·鲁尼	兄弟姐妹
费孝通	吴文藻	同门
叶剑英	叶明子	祖孙
葛淑珍	赵玉芳	父母
蔡畅	李富春	夫妻
洪天明	徐子淇	情侣
李宣捷	庄玉生	合作
郭晶晶	吴敏霞	合作
李圣根	李贤义	父母
迈克尔·道格拉斯	柯克·道格拉斯	父母
李天一	李双江	父母
郑经	郑克臧	父母
刘芸	郑钧	夫妻
赵砚奎	张长林	师生
林小群	白超雄	夫妻
钱似莺	洪济	夫妻
俞扬和	蒋方良	父母
前原诚司	前原爱里	夫妻
吕雉	吕禄	亲戚
蒋得元	蒋孝严	祖孙
徐申如	徐骝良	合作
邓广铭	邓小南	父母
赵建铭	陈幸妤	夫妻
孙甫亭	孙怡云	父母
小香玉	徐帆	合作
徐小岩	徐向前	父母
蔡尚思	梁启超	师生
姚水娟	竺素娥	合作
李裹儿	武三思	父母
张茜	陈毅	夫妻
文强	文兵	兄弟姐妹
汉昭帝	上官小妹	夫妻
王豫颖	胡德平	夫妻
马化腾	马陈术	父母
吕大防	吕大忠	兄弟姐妹
刘松林	刘谦初	父母
孙甫亭	王晶华	师生
曹上	曹操	父母
曹睿	曹丕	父母
张娣	冯小刚	夫妻
唐杰忠	姜昆	合作
茅以升	茅玉麟	父母
朱仲丽	王稼祥	夫妻
刘伯承	刘蒙	父母
刘秀	刘縯	兄弟姐妹
马海龙	吴鉴泉	祖孙
司马懿	朱铄	好友
黄宗江	朱嘉琛	夫妻
郑多彬	李姜熙	情侣
钱思进	何泽慧	父母
陶希圣	黄现璠	同门
李菁	连丽如	父母
陈彦衡	谭鑫培	好友
黄秋爽	张永刚	师生
尼尔·阿姆斯特朗	巴兹·奥尔德林	合作
陈正薇	梅兰芳	师生
汪建民	纪文蕙	情侣
王小宝	赵本山	师生
方招	何东旭	同门
萧连芳	李玉娟	夫妻
郑伊健	蒙嘉慧	情侣
车晓彤	车晓	父母
萧亚轩	萧圣谚	兄弟姐妹
谭晓令	李金泉	师生
李益群	谢亚龙	夫妻
康子林	杨素兰	合作
包伟铭	包小柏	兄弟姐妹
张小巧	毛头	师生
张卫健	苏永康	好友
柏拉图	苏格拉底	师生
司马懿	曹休	合作
林心如	林志颖	情侣
小筱月珍	筱文滨	合作
郭槐	贾充	夫妻
孙荣蕙	尚小云	师生
邹韬奋	沈粹缜	夫妻
周春秀	冯小艺	师生
陈撄宁	胡海牙	师生
夏侯渊	夏侯光姬	祖孙
王光英	刘少奇	兄弟姐妹
王子腾	王夫人	兄弟姐妹
杜义德	邓小平	上下级
伍咏薇	练海棠	夫妻
李途纯	高博文	亲戚
蔡万春	蔡辰威	父母
何泽慧	钱民协	父母
濮存昕	苏民	父母
犬夜叉	戈薇	夫妻
邓卓翔	杜威	合作
蔡康永	刘坤龙	情侣
王婉华	张君秋	师生
黄旭	黄玉斌	师生
陈清渊	蔡学彦	好友
田益宾	张兰	夫妻
周迅	李亚鹏	情侣
马鹤凌	马莉君	父母
朱德刚	魏文亮	师生
曾宪梓	曾智明	父母
张翠山	俞岱岩	同门
刘湘	刘文辉	亲戚
李白	许氏	夫妻
汪桂英	汪野亭	父母
元春	贾母	祖孙
罗素	派屈西亚·斯彭斯	夫妻
周伯宜	周介孚	父母
王天伦	王天秀	兄弟姐妹
马三立	高笑林	师生
吴素秋	陈盛荪	师生
谭元寿	谭正岩	祖孙
孙匡	孙策	兄弟姐妹
王辩	王翔千	父母
司马繇	诸葛诞	祖孙
张无忌	殷素素	父母
张彩林	雪艳琴	师生
韩鹏	李金羽	合作
贾赦	孙绍祖	父母
胡军	胡松华	亲戚
耿飚	耿志远	父母
真田昌幸	真田幸隆	父母
王韵通	王怡仙	祖孙
薛永年	韩子康	师生
唐代宗	李暹	父母
刘金宝	王雪冰	同门
陈垣	曾庆瑛	祖孙
王尚君	尚宝信	祖孙
茅威涛	郭晓男	夫妻
孙科	严蔼娟	情侣
麻生太郎	吉田茂	祖孙
王菲	那英	好友
皇甫谧	皇甫叔侯	父母
赵雅芝	黄汉伟	夫妻
黄志红	张丽	好友
查尔斯王子	威廉王子	父母
李克勤	卢淑仪	夫妻
孙连仲	孙湘德	父母
郭春山	唐玉喜	师生
埃斯特拉达	拉妮恩利奎兹	情侣
陈幸妤	赵翊佑	父母
何桂山	金秀山	师生
姜昆	唐杰忠	合作
普密蓬·阿杜德	玛希敦·阿杜尔雅戴	父母
袁克坚	袁篆祯	兄弟姐妹
吴雁泽	喻宜萱	师生
土登	米玛	合作
阳友鹤	许倩云	师生
郭富城	熊黛林	情侣
郎昆	刘岩	夫妻
容星桥	关月英	夫妻
武田信廉	武田信虎	父母
曹植	曹冲	兄弟姐妹
李智屏	柳大华	师生
吴绮莉	成龙	情侣
王度庐	李丹荃	夫妻
谷望江	谷景生	父母
金正日	金日成	父母
秦昭襄王	秦惠文王	父母
林梦飞	林华国	父母
曹世才	曹二庚	亲戚
汉高祖刘邦	吕雉	夫妻
邓超	孙俪	夫妻
李国静	杜近芳	师生
服部良一	服部克久	父母
蒋友青	蒋友柏	兄弟姐妹
小仲马	大仲马	父母
宋德珠	宋丹菊	父母
罗文	关淑怡	师生
浦通修	浦安修	兄弟姐妹
王心凌	郑元畅	好友
于凤至	于文斗	父母
孔继宁	贺子珍	祖孙
卫青	刘彻	兄弟姐妹
孙明珠	那正鑫	夫妻
沈九娘	唐伯虎	夫妻
江丙坤	陈美惠	夫妻
高吹万	高君藩	父母
日暮戈薇	日暮草太	兄弟姐妹
陶阳	龙叶凤	父母
郭凯敏	张芝华	夫妻
黎民伟	黎海山	兄弟姐妹
董存瑞	董全忠	父母
宋庆龄	宋霭龄	兄弟姐妹
周作人	羽太信子	夫妻
李莞	金泰熙	兄弟姐妹
张仃	灰娃	夫妻
羽田孜	羽田武嗣郎	父母
贾赦	贾琏	父母
约翰·肯尼迪	爱德华·肯尼迪	兄弟姐妹
金正日	金正男	父母
曹冲	曹操	父母
顾慰连	李竞雄	师生
酒井法子	高相祐一	夫妻
蒋孝严	章亚若	父母
刘国正	余志国	师生
马季	于波	夫妻
刘觉民	樊钟秀	好友
元华	洪金宝	合作
戚烈云	戚扬	父母
马景涛	吴佳尼	夫妻
齐白石	齐媛媛	祖孙
聂卫平	兰莉娅	夫妻
阎秋霞	白云鹏	师生
谷开来	范承秀	父母
王岳伦	李湘	夫妻
颜永京	颜惠庆	父母
奥尼尔	布朗	师生
张小凡	田不易	师生
耿巧云	刘长瑜	师生
陈微明	孙禄堂	师生
吴晗	蒋山荫	父母
林则徐	林聪彝	父母
黄长发	黄长兴	兄弟姐妹
李琳	王小列	夫妻
梅加瓦蒂	离异	夫妻
黄健	桑兰	情侣
彭加木	夏叔芳	夫妻
高思博	朱立伦	兄弟姐妹
袁立	徐威	情侣
牛子厚	牛化麟	父母
孟桐	那英	夫妻
殷旭	章子男	夫妻
查尔斯	戴安娜	夫妻
马岳梁	吴鉴泉	父母
王京阳	叶静子	夫妻
刘永好	刘永言	兄弟姐妹
田蕴章	田荫亭	父母
张德培	刘安宝	夫妻
沈湘	关牧村	师生
何晴	许亚军	夫妻
吕丽萍	孙海英	夫妻
郭沫若	郭博	父母
三毛	林青霞	好友
魏松	周小燕	师生
王幼卿	王瑶卿	师生
北岛康介	佐藤久佳	合作
马仲英	马海渊	祖孙
蔡志明	蔡加敏	父母
俞明震	俞大纯	父母
陈慧佳	刘连云	师生
孙禄堂	郝为真	师生
罗素	尼古拉斯·罗素	祖孙
张志宽	曹淑珍	夫妻
鲁迅	周建人	兄弟姐妹
周海婴	张纯华	父母
曾志伟	王美华	夫妻
方瑀	蔡依珊	父母
洪金宝	洪天明	父母
林慧萍	张菲	情侣
谢颖	李永波	夫妻
高联奎	高盛麟	亲戚
谢天顺	刘西雨	合作
封凤子	赵清阁	好友
谭晶	周丽萍	父母
张庆林	赵玉芳	合作
刘诗雯	郭跃	合作
谭希林	吴文彬	夫妻
乐蒂	陈厚	夫妻
姜妙香	童寿苓	师生
郎昆	马艳丽	夫妻
钱琳琳	张译	夫妻
常澍田	德寿山	师生
霍震寰	霍思纬	父母
毛泽覃	毛泽民	兄弟姐妹
陈丽芳	程砚秋	师生
穆铁柱	王专红	夫妻
费玉清	张菲	兄弟姐妹
于谦	于冕	父母
朗·霍华德	琼·霍华德	父母
刘交	刘邦	兄弟姐妹
孙绍	孙策	父母
邓婕	张默	父母
谭震林	谭泾远	父母
吴敦义	马英九	上下级
钱伟长	钱声一	父母
沈启贤	何振亚	合作
宫崎市定	内藤湖南	师生
卫青	平阳公主	夫妻
马莉莉	李灵珠	夫妻
赵丹	黄宗英	夫妻
筱文滨	袁滨忠	师生
傅海峰	傅铭英	父母
费英东	扬古利	合作
柳真	朴龙河	情侣
张无忌	赵敏	夫妻
梁思宁	梁思懿	兄弟姐妹
犬大将	犬夜叉	父母
翁狄森	蒋怡	夫妻
孙宝琦	袁世凯	亲戚
郎咸平	樊小纯	情侣
梁秀娟	梁花侬	父母
魏玩	曾布	夫妻
冯弘	冯翼	亲戚
程小东	马玉成	师生
文爱马	马伊琍	父母
黄现璠	萧一山	同门
沙僧	唐僧	师生
周循	周瑜	父母
戴安娜	威廉王子	父母
李硕勋	赵君陶	夫妻
犬养毅	芳泽操	父母
惜春	贾珍	兄弟姐妹
李紫阳	林佳楣	父母
周汶锜	高以翔	情侣
罗尔纲	胡适	师生
王尚君	赵国忠	合作
洪天明	洪金宝	父母
赵兰坤	连战	父母
李保田	李彧	父母
廖静秋	谭香云	师生
张琴秋	沈泽民	夫妻
龚普生	章汉夫	夫妻
麦迪	姚明	合作
关兴	关羽	父母
常俊丽	张宝英	合作
王向党	王玉芬	父母
高盛麟	高庆奎	父母
李海泉	李秋源	父母
曹真	曹氏	兄弟姐妹
乔冠华	龚澎	夫妻
杜淳	杨丽	父母
邱义仁	陈水扁	合作
吴碧霞	邹文琴	师生
胡小凤	荀慧生	师生
苍井空	赤西仁	情侣
陶铸	曾志	夫妻
任剑辉	白雪仙	合作
金月楼	玉牡丹	合作
李先念	李小林	父母
郭英丽	刘伯玲	同门
彭帅	李慧芝	合作
傅泾波	傅暖泠	父母
丁英	李双江	夫妻
汤镇业	汤镇宗	兄弟姐妹
谭小培	叶盛长	父母
诸葛怀	诸葛丰	亲戚
石齐	丁尚谦	师生
杨惠妍	陈翀	夫妻
郑孟霞	唐涤生	夫妻
本·高登	罗尔·邓	合作
王冠丽	刘萍	师生
赵一曼	赵掖贤	父母
王励勤	刘彦池	情侣
谭富英	谭小培	父母
新凤霞	杨金香	兄弟姐妹
戴天民	毕尔格麦斯特教授	师生
兰多夫	鲁本-帕特森	合作
潘迪生	余桂珠	夫妻
何爱喻	何东	亲戚
刘晓兰	李老能	师生
赵元任	杨步伟	夫妻
胡小石	曾农髯	师生
马幼禄	沈学正	师生
柳永	倩娘	夫妻
冯弘	冯跋	兄弟姐妹
王子腾	薛姨妈	兄弟姐妹
殷天正	殷素素	父母
贯盛习	贯盛吉	同门
武正豪	杨宝森	师生
马连良	马崇义	父母
周洋	王濛	合作
玄彬	金善雅	合作
李嘉诚	李泽钜	父母
王志才	王烁	父母
窝阔台	成吉思汗	父母
俞飞鸿	刘德华	合作
蒋兴权	西热力江	师生
吴镇	吴森	亲戚
高圆圆	于小伟	情侣
奥巴马	巴拉克·侯赛因·奥巴马一世	父母
吴英华	吴鉴泉	父母
妮可·基德曼	Kidman	父母
筱吉仙	田桂兰	师生
应宁	王谦祥	师生
符光耿	王大同	合作
马雅舒	詹姆斯·罗伯特·海耶斯	夫妻
谢天笑	付兰	夫妻
谢振南	张柏芝	父母
冼夫人	冯盎	祖孙
斯大林	斯韦特兰娜·阿莉卢耶娃	父母
樊馨蔓	张纪中	夫妻
罗明珠	王培宏	夫妻
蒋纬国	宋美龄	父母
舒淇	林熙蕾	好友
唐太宗	唐高祖	父母
王明明	李苦禅	师生
汪成荣	孙英杰	夫妻
王皓	王忠全	父母
耿伯春	卢福来	合作
罗素	豆拉·勃拉克	夫妻
黄兴	黄伟民	祖孙
谢振轩	张柏芝	父母
秦汉	邵乔茵	夫妻
田中真纪子	田中直纪	夫妻
黄志忠	孙红雷	同门
朱立伦	高思博	兄弟姐妹
红孩儿	牛魔王	父母
冯洪达	冯玉祥	父母
龙云	龙绳曾	父母
貂蝉	王允	父母
孔令侃	宋蔼龄	父母
莫妮卡·贝鲁奇	Bellucci	父母
李德伦	斯特恩	合作
朱阔泉	叶寿亭	同门
彦涵	罗工柳	同门
周佳纳	周英华	父母
宗馥莉	宗庆后	父母
郑小龙	古龙	父母
连战	赵兰坤	父母
薄熙莹	胡明	父母
孙昌宁	王学圻	夫妻
马唯中	马英九	父母
王盛德	张天爱	夫妻
杨畹农	沈小梅	师生
陈逸飞	宋美英	夫妻
薛蛮子	薛子正	父母
姜昆	姜珊	父母
鲁伟鼎	鲁冠球	父母
孙治强	孙国升	父母
许亚军	张澍	夫妻
王羲之	王献之	父母
方宏进	方贞	父母
吴碧波	田敏	师生
容永道	梁士诒	祖孙
任贤齐	阿牛	好友
典韦	典满	父母
典韦	许褚	合作
杜如晦	屈突通	合作
袁和平	袁日初	兄弟姐妹
李贞	张启龙	夫妻
胡碧兰	王云卿	师生
侯佩岑	黄伯俊	夫妻
甄子丹	甄济嘉	父母
冼夫人	冯魂	祖孙
邓光荣	严珍纳	夫妻
梵高	安娜·科妮莉娅·卡本特期	父母
李香凝	李小龙	父母
祝钒刚	萧亚轩	情侣
秦剑	林翠	夫妻
布冯	塞雷多娃	夫妻
宋远桥	莫声谷	同门
鸠山一郎	鸠山和夫	父母
济尔哈朗	舒尔哈齐	父母
林黛玉	林如海	父母
莫言	管笑笑	父母
龙剑笙	白雪仙	师生
单雯	张继青	师生
陈建州	范玮琪	夫妻
张佩纶	张恭庆	祖孙
李子君	张可欣	合作
汪诗诗	汪圆圆	兄弟姐妹
曹敏莉	黄长兴	情侣
许世友	许援朝	父母
冯潇霆	赵盈	夫妻
曹操	曹峻	父母
李应生	李沛基	兄弟姐妹
赵佩茹	焦寿海	师生
郑裕彤	周翠英	夫妻
高晓松	沈欢	夫妻
花五宝	张庞氏	亲戚
李伟建	李雪歌	父母
黄克诚	唐棣华	夫妻
曹华	曹宪	兄弟姐妹
谷德昭	谷薇丽	兄弟姐妹
叶绍德	林家声	好友
王菲	王佑林	父母
张柏芝	谢振轩	父母
陈鹤年	陈乔年	兄弟姐妹
张豪龙	张柏芝	兄弟姐妹
梁思礼	梁启超	父母
雒芊芊	陈天桥	夫妻
俞步兰	俞菊笙	祖孙
黄铁良	尹笑声	合作
周璇	严华	夫妻
那辛	那英	兄弟姐妹
林淑如	郭晓玲	父母
张琼姿	张琼玲	兄弟姐妹
乌兰夫	乌可力	父母
姚沁蕾	叶莉	父母
吴小楼	杨同时	师生
刘备	刘禅	父母
曹芳	曹叡	父母
任剑辉	红线女	合作
毛利兰	妃英理	父母
慕容熙	苻训英	夫妻
库淑兰	魏伊平	师生
周少麟	周英华	兄弟姐妹
何甘棠	何爱榆	父母
马凤图	吴懋堂	亲戚
薄望知	李丹宇	父母
阎锡山	阎志宽	父母
杜如晦	萧瑀	合作
周星驰	朱茵	情侣
胡小石	王季思	师生
杨千嬅	丁子高	夫妻
犬夜叉	杀生丸	兄弟姐妹
宋江	阎婆惜	夫妻
戈米沙	戈军	父母
宫粉红	陈非侬	夫妻
徐娇	周星驰	父母
李艺	李书福	父母
刘倩婷	李丞责	情侣
牛得草	张仙草	师生
王越古	冯天薇	合作
袁世海	孙盛文	师生
刘秋宏	孙琳琳	合作
宋德珠	朱桂芳	师生
靓次伯	任剑辉	合作
马相伯	马建忠	兄弟姐妹
宋卫平	毛昱衡	情侣
冉莹颖	邹市明	夫妻
林挺生	林镇华	父母
吴昌硕	吴东迈	父母
赵涛	贾樟柯	夫妻
张文顺	郭德纲	师生
王昭君	汉元帝	夫妻
刘德一	午马	合作
小沈阳	沈春阳	夫妻
乔治·巴顿	乔治·史密斯·巴顿	父母
汤敏	骆玉笙	师生
孙匡	吴夫人	父母
李玉茹	叶盛兰	合作
张翠山	张无忌	父母
高丽虹	洪金宝	夫妻
尚慧敏	尚长麟	师生
毛泽东	毛泽民	兄弟姐妹
江上青	江泽玲	父母
李开复	柳传志	合作
邵华	毛新宇	父母
曹仁	曹炽	父母
邓育昆	刘雪华	夫妻
谭元寿	谭孝曾	父母
吴奇隆	苏有朋	合作
许地山	林月森	夫妻
赵本山	马丽娟	夫妻
潘基文	柳淳泽	夫妻
陈非侬	宫粉红	夫妻
苗彤	戚美珍	父母
王又曾	王笃学	兄弟姐妹
水谷隼	吉田海伟	合作
泷川一益	泷川益氏	亲戚
夏姬	子蛮	夫妻
贾敬	贾代化	父母
周瑜	周胤	父母
孙芸芸	孙莹莹	兄弟姐妹
周润发	陈荟莲	夫妻
杨惠妍	杨国强	父母
周英华	周佳纳	父母
赵培鑫	孟小冬	合作
霍元甲	霍元卿	兄弟姐妹
杨进明	杨少华	父母
何佳山	刘大头	师生
范文芳	李铭顺	夫妻
马步青	马元海	兄弟姐妹
季芹	王仁甫	夫妻
梅兰芳	梅葆玖	父母
马蓉	王宝强	夫妻
徐碧云	毕谷云	师生
陈小春	谢天华	合作
茹莱卿	杨隆寿	师生
高凤山	罗荣寿	合作
卡卡	迪甘	兄弟姐妹
苏嘉全	洪恒珠	夫妻
谭小培	杨盛春	父母
王清海	李斯忠	师生
朱慧珍	朱安婕	父母
许广平	周作人	兄弟姐妹
陈中	陈新生	父母
洪战辉	宋娜杰	夫妻
郭破虏	郭襄	兄弟姐妹
陈慧琳	陈司翰	兄弟姐妹
工藤静香	木村心美	父母
刘半农	鲁迅	好友
凯蒂·赫尔姆斯	汤姆·克鲁斯	夫妻
蒋友青	蒋经国	祖孙
傅作义	傅作仁	兄弟姐妹
张世麟	张幼麟	父母
金正日	金敬惠	父母
宋勇	宋久林	合作
钱声一	钱穆	兄弟姐妹
郭跃	郭向生	父母
福原爱	王励勤	情侣
吴承瑛	吴晋妤	父母
封至模	马科	师生
连震东	连战	父母
赵亮	胡敬	夫妻
汉武帝	汉文帝	祖孙
刘政会	虞世南	合作
孙多慈	徐悲鸿	情侣
王世霞	王瑶卿	亲戚
刘文辉	刘元彦	父母
李冰冰	李雪	兄弟姐妹
邢夫人	贾赦	夫妻
陆小曼	徐志摩	夫妻
钱钟书	钱福炯	祖孙
宋子文	蒋介石	兄弟姐妹
铁扇公主	牛魔王	夫妻
马诚方	马四立	祖孙
邱富棠	赵喜魁	兄弟姐妹
小岚云	白云鹏	合作
竺基焕	竺素娥	师生
孙穗芳	严蔼娟	父母
俞明颐	曾广珊	夫妻
铫期	铫猛	父母
毛泽东	杨开慧	夫妻
罗震环	杨幂	好友
毛岸青	邵华	夫妻
邱复生	葛福鸿	情侣
洪金宝	洪天祥	父母
慕容盛	慕容宝	父母
陈赓	陈知非	父母
王娡	金王孙	夫妻
吴竹似	吴敬瑗	父母
门敢红	梁成赞	夫妻
孙胜男	贾郁沁	父母
薄熙宁	薄熙永	兄弟姐妹
胡雪岩	翠环	夫妻
罗素	阿莉丝·皮尔索尔·史密斯	夫妻
岑春煊	岑毓英	父母
金月楼	金梅楼	兄弟姐妹
叶剑波	傅明宪	夫妻
晴雯	贾宝玉	上下级
夏伊乔	刘海粟	夫妻
靓次伯	金山炳	合作
霍元甲	刘振声	师生
董浩	张微	夫妻
孙毓敏	梅葆玖	合作
王军霞	战宇	夫妻
虞姬	项羽	夫妻
陶大伟	陶喆	父母
靓元亨	陈非侬	师生
吕良伟	吕善婷	亲戚
李海泉	李震彪	父母
叶准	叶问	父母
梦鸽	李天一	父母
武术家	董英俊	师生
姚晨	闫妮	好友
曹世才	曹瑞石	父母
杨荣环	梅兰芳	师生
爱因斯坦	爱德华·爱因斯坦	父母
小林泉美	张栩	夫妻
邵云环	曹荣飞	夫妻
冯至	姚可崑	夫妻
陶希圣	鞠清远	师生
慕容盛	兰妃	夫妻
梅兰芳	梅巧玲	祖孙
贾斯汀·汀布莱克	布兰妮·斯皮尔斯	情侣
陈数	赵胤胤	夫妻
小香玉	李冰	合作
李婷芷	李婷宜	兄弟姐妹
张咏梅	袁雪芬	同门
谭志道	谭富英	祖孙
郑秀文	刘德华	好友
沈湘	迪里拜尔	师生
柯南	服部平次	好友
任哲中	刘毓中	师生
虢国夫人	杨玉环	兄弟姐妹
梁文博	伍文忠	师生
曹宝禄	李芬	师生
薛蟠	夏金桂	夫妻
朱芳雨	胡美	夫妻
张少楼	张月楼	父母
杨惠妍	杨子莹	兄弟姐妹
明智光秀	明智光安	亲戚
马思聪	马瑞雪	父母
黄少谷	黄任中	父母
赵高	蒙毅	合作
袁克桓	陈徵	夫妻
赵又廷	赵树海	父母
王恩怀	王秀春	祖孙
赵云	赵统	父母
吉姆·洛威尔	弗莱德·海斯	合作
爱德华一世	爱德华二世	父母
陈兰彬	容闳	合作
竺小招	竺水招	父母
林永健	周冬齐	夫妻
蒋碧微	张道藩	情侣
柴静	冯唐	好友
马岳梁	吴公藻	亲戚
刘表	蔡氏	夫妻
张小凡	曾书书	同门
侯玉琢	侯东海	师生
林立衡	林彪	父母
曹丕	曹操	父母
马聚泉	包惠申	合作
许冠杰	许冠武	兄弟姐妹
孔祥熙	孔令侃	父母
高联奎	高庆奎	兄弟姐妹
刘砚亭	钱金福	师生
陈青远	陈仲山	父母
冈田克也	冈田卓也	父母
胡为真	胡宗南	父母
刘銮雄	李嘉欣	情侣
曾启荣	曾金英	兄弟姐妹
宋蔼龄	孔令侃	父母
冯弘	冯崇	父母
哈里·雷德克纳普	弗兰克·兰帕德	亲戚
水岛宏	绚香	情侣
魏梅照	李忠萍	合作
白全福	侯宝林	合作
唐肃宗	李系	父母
陆小曼	刘海粟	师生
林平之	令狐冲	同门
夏侯敦	夏侯渊	兄弟姐妹
丁善德	余隆	祖孙
阿炳	华清和	父母
赵学义	王莉	师生
苏民	濮存昕	父母
金大中	金弘业	父母
廖承志	何香凝	父母
刘晓兰	刘凤	师生
杨荣环	王艳	师生
苏西莲	战殊	父母
肯尼迪	小约瑟夫·肯尼迪	兄弟姐妹
马东敏	李彦宏	夫妻
房仕德	房仕胜	兄弟姐妹
刘政会	刘政会	合作
武田胜赖	北条氏政	兄弟姐妹
邵华	刘思齐	兄弟姐妹
董仲舒	胡母生	合作
筱文滨	徐宝奎	师生
李凌枫	锡子刚	师生
聂卫平	王静	夫妻
苍井空	高野二郎	情侣
李德裕	李宗闵	合作
孙法民	孙芸芸	祖孙
周春秀	周付元	父母
伏明霞	于芬	师生
刘云天	曹云金	合作
王万梅	程玉英	师生
廉静儿	张东健	情侣
马云	蔡崇信	合作
叶刘淑仪	刘福成	父母
陈万水	宋楚瑜	夫妻
卡雷拉斯	多明戈	合作
戚美珍	苗侨伟	夫妻
孙耀威	陈美诗	情侣
赵宏博	申雪	夫妻
张居正	张简修	父母
诺贝尔	艾马纽·诺贝尔	父母
杨露禅	陈长兴	师生
代善	努尔哈赤	父母
卡斯特罗	米尔塔	夫妻
冯金芙	姜妙香	夫妻
萨马兰奇·萨利萨奇斯	萨马兰奇	父母
唐德刚	吴开先	父母
尼克松	汉纳·米尔豪斯·尼克松	父母
张欣	潘石屹	夫妻
朴寒星	Se7en	情侣
程昱	李典	合作
叶璇	吴卓羲	好友
李白	李伯禽	父母
理查一世	安妮	父母
周勃	周亚夫	父母
朱丽倩	朱金城	父母
吉鸿昌	吉筠亭	父母
梅兰芳	程砚秋	好友
何爱榆	何甘棠	父母
朱执信	杨道仪	夫妻
万伯翱	万里	父母
黎洪模	黎健图	父母
陈慧琳	刘建浩	夫妻
孙穗芬	孙穗芳	兄弟姐妹
吴尊	赵晨浩	好友
珍妮·巴斯	贾尼·巴斯	兄弟姐妹
韩冬柏	王志怡	师生
方镇泉	方阿常	父母
庾澄庆	王滢	亲戚
陈丹淮	陈毅	父母
马思纯	蒋雯丽	亲戚
刘亭	刘少奇	父母
茅以升	权桂云	夫妻
费孝通	黄现璠	同门
葛洪	黄初平	师生
曹节	曹操	父母
汉献帝	伏寿	夫妻
郭美美	王军	情侣
罗海琼	陈坤	合作
徐梦桃	陈洪斌	师生
巩汉林	巩天阔	父母
陈美诗	孙耀威	情侣
理雅各	玛丽	夫妻
卢小玉	周明娟	师生
荣少昌	刘连玉	同门
甘地	Gandhi	父母
吴蔚然	吴阶平	兄弟姐妹
伏明霞	梁皓嘉	父母
尤三姐	尤氏	父母
杨威	邢傲伟	合作
王晶华	王本秀	师生
曹斯杰	郭守正	亲戚
张庆林	史慧颖	合作
梅巧玲	陈金雀	父母
陈冠希	陈俞希	情侣
邓永佳	邓丽君	亲戚
陈金莲	姚水娟	合作
郎咸平	张玮	夫妻
英如镝	梁欢	父母
周伯通	王重阳	同门
梁思顺	梁思庄	兄弟姐妹
关羽	刘备	兄弟姐妹
孙道存	吴逸萍	夫妻
连胜武	连惠心	兄弟姐妹
孙科	孙治平	父母
蒋碧微	徐伯阳	父母
金正恩	金正日	父母
卡斯特罗	安东尼奥	父母
李银河	王小波	夫妻
游锡堃	林义雄	亲戚
岳不群	劳德诺	师生
马如龙	沛小岚	夫妻
黄继光	邓芳芝	父母
汪平孙	汪野亭	祖孙
安德鲁·约翰逊	伊莱扎·麦卡德尔	夫妻
申军谊	贾妮	情侣
寇准	九僧	好友
关羽	赵云	合作
周朴园	侍萍	夫妻
唐德刚	吴昭文	夫妻
林丹	夏煊泽	合作
马步芳	马麟	亲戚
廖静文	徐悲鸿	夫妻
陈望道	蔡慕晖	夫妻
冯子洋	花淑兰	师生
卫子夫	刘彻	夫妻
拉吉夫·甘地	山齐·甘地	兄弟姐妹
陈婉珍	何鸿燊	夫妻
白歆惠	毛加恩	情侣
胡瓜	秀秀	夫妻
黎洪模	黎应图	父母
周采茨	周少麟	兄弟姐妹
汉元帝	王政君	夫妻
袁克坚	袁克权	兄弟姐妹
刘建宏	黄健翔	合作
孙皓	孙和	父母
孙俪	邓超	夫妻
章宗义	六小龄童	父母
王家卫	陈以靳	夫妻
常杰淼	张杰鑫	师生
胡适	胡思杜	父母
赵飞燕	汉成帝	夫妻
顾毓琇	顾慰庆	父母
筱兰英	姚长海	夫妻
谢天顺	赵伟洲	合作
张彭春	张伯苓	兄弟姐妹
江泽慧	江上青	父母
拖雷	元宪宗	父母
谭富英	谭鑫培	祖孙
林正英	郑冰冰	夫妻
卢兰	朱琳	合作
文震孟	文徵明	亲戚
冠佑	五月天	合作
石小梅	王正来	同门
廖凤舒	廖香词	父母
毛远新	毛泽东	亲戚
魏莲芳	朱素云	师生
张曼玲	周婧	师生
李国能	李国宝	兄弟姐妹
方声洞	方君笄	兄弟姐妹
何念慈	孙道存	夫妻
郑伊健	邵美琪	情侣
房祖名	成龙	父母
梁汉文	林文慧	夫妻
廖承志	陈香梅	亲戚
大仲马	小仲马	父母
傅家俊	丁俊晖	好友
霍启刚	霍启山	兄弟姐妹
廖承志	经普椿	夫妻
樊少皇	樊梅生	父母
曹乘	李姬	父母
黄有龙	叶翠翠	情侣
刘禅	诸葛亮	上下级
赖文峰	赖昌星	亲戚
关羽	关彝	祖孙
曾国犹	曾志伟	父母
吴敬琏	吴竹似	父母
慈禧	咸丰	夫妻
达科塔·范宁	艾丽·范宁	兄弟姐妹
范瑞娟	傅全香	合作
辽景宗耶律贤	辽世宗	父母
陈晓旭	郝彤	夫妻
焦守云	余音	父母
金范	李民浩	好友
袁咏仪	张慕童	父母
成淑	赵芸蕾	合作
盛静生	盛军海	父母
李吉瑞	程永龙	合作
郭全宝	刘宝瑞	合作
吴君如	陈可辛	夫妻
陆小曼	陆荣昌	祖孙
靖正恭	党甘亭	师生
费玉清	费贞绫	兄弟姐妹
黄铁良	黄仲华	亲戚
吕后	刘盈	父母
丁永利	高盛麟	师生
四驱兄弟	星马豪	兄弟姐妹
胡志强	邵晓铃	夫妻
田汉	安娥	夫妻
李元霸	李渊	父母
高百岁	关正明	合作
吕大忠	吕大钧	兄弟姐妹
谭梅	朱思潭	父母
邓演达	宋庆龄	好友
冯宝华	佟手本	合作
孙淳	傅丽莉	夫妻
袁世凯	袁甲三	亲戚
慕容吐谷浑	慕容廆	兄弟姐妹
方振武	方心让	父母
蔡少芬	张楚儿	父母
李嘉存	高英培	师生
马金凤	梅兰芳	师生
孙琳琳	张会	合作
李飞龙	红线女	合作
贾珠	李纨	夫妻
张謇	翁同龢	好友
干露露	干毛毛	兄弟姐妹
陈羽凡	羽·泉	合作
索菲亚·科波拉	弗朗西斯·福特·科波拉	父母
曹训	曹则	兄弟姐妹
汪桂芬	程长庚	师生
周洋	王淑英	父母
张栩	小林泉美	夫妻
苏丹丹	叶明子	父母
常连安	常宝华	父母
袁世凯	袁克定	父母
关公	张飞	兄弟姐妹
王玥	田雨	夫妻
流川枫	流川龙介	父母
甘少苏	梁宗岱	夫妻
高百岁	陈鹤峰	合作
魏文亮	朱德刚	师生
庞德	庞柔	兄弟姐妹
俞步兰	俞振庭	父母
马东	马季	父母
佐藤荣作	佐藤宽子	夫妻
虎美玲	熊小玲	师生
韩子康	薛永年	师生
马唯中	马元中	兄弟姐妹
侯瓒	侯耀华	亲戚
杨梅生	刘坚	夫妻
叶圣陶	叶至善	父母
林百欣	顾瑞英	夫妻
盖叫天	张翼鹏	父母
傅聪	卓一龙	夫妻
萧圣谚	萧亚轩	兄弟姐妹
于景元	于七	师生
郭守正	郭晓玲	兄弟姐妹
安吉丽娜·朱莉	乔恩·沃伊特	父母
杨过	郭靖	亲戚
项堃	阮斐	夫妻
马志明	马覃	情侣
袁雪芬	戚雅仙	师生
杨康	杨铁心	父母
侯君集	长孙无忌	合作
王诗龄	王岳伦	父母
林月琴	罗荣桓	夫妻
程昱	曹丕	上下级
金正日	金正哲	父母
胡美	朱芳雨	夫妻
张韶涵	颜行书	情侣
周春秀	江云英	父母
燕姿	孙燕美	兄弟姐妹
赵云	公孙瓒	上下级
丁子高	丁子杰	兄弟姐妹
陈晓炜	于子恒	父母
谢葆璋	冰心	父母
克劳馥	理查德·基尔	夫妻
陈忠志	刘永杰	师生
叶剑英	危拱之	夫妻
莫科	王凡	夫妻
梁咏琪	窦尔博	情侣
董翠娜	张学浩	夫妻
贾玲	白凯南	合作
安乐公主	李显	父母
笑林	马季	师生
王予柔	陈建州	好友
唐寅	曹凤	好友
连震东	连横	父母
蔡依珊	蒋孝武	亲戚
钱永佑	钱学榘	父母
尉迟恭	杜如晦	合作
唐天际	李达	合作
祁宏	沈谦倩	夫妻
奥尼尔	菲利浦·哈里森	父母
赵胤胤	黄子珈	夫妻
醉丽君	徐碧云	师生
王璐瑶	李辙	夫妻
李彧	李保田	父母
小花玉兰	花玉兰	父母
陈彤云	哈玉民	夫妻
胡传	冯顺弟	夫妻
曾江	秦剑	兄弟姐妹
文强	周晓亚	夫妻
陆士嘉	张克澄	父母
霍光	霍去病	兄弟姐妹
王敬之	谭雪	夫妻
汉武帝	刘弗陵	父母
黄立行	蔡依林	情侣
张韶涵	张志宏	父母
栾菊杰	顾梦佳	父母
胡适	胡传	父母
元奎	元德	同门
陆建章	冯玉祥	亲戚
侯佩岑	邱嘉雄	父母
陈微明	杨澄甫	师生
张庆林	杨东	合作
钱金福	李永利	师生
夏明衡	夏明翰	兄弟姐妹
陈勋奇	王福龄	师生
吴卓林	吴绮莉	父母
周璟馨	周令飞	父母
林艾为	林心如	兄弟姐妹
戴思聪	戴蕴慧	父母
庐隐	李唯建	夫妻
王光亚	陈毅	父母
王娡	臧儿	父母
陈凯歌	倪萍	情侣
徐尚田	叶问	师生
路三宝	于连泉	师生
庹宗康	况明洁	情侣
冯弘	冯业	父母
张谋之	张乐怡	父母
于俊波	郭启儒	合作
李双江	丁英	夫妻
铁木真	弘吉剌氏·诃额仑	父母
赵晨浩	许智伟	好友
王杰	王筱翠	父母
徐天红	戚雅仙	合作
罗炳辉	陈毅	合作
孔令辉	刘国梁	合作
郭秀仪	黄琪翔	夫妻
薛宝钗	薛姨妈	父母
曾宝仪	周渝民	情侣
陶鹏飞	张学良	父母
徐根宝	范志毅	师生
郝春年	鲍桂山	师生
里奥·费迪南德	丽贝卡·爱丽逊	夫妻
李光耀	柯玉芝	夫妻
蒋孝勇	蒋经国	父母
何鸿燊	陈婉珍	夫妻
黄燕虹	黄秀虹	兄弟姐妹
龚琳娜	老锣	夫妻
高盛麟	班世超	合作
曹禺	郑秀	夫妻
萧绎	萧纪	兄弟姐妹
白雪仙	新马师曾	合作
梁洛施	李长治	父母
金敬姬	金正男	亲戚
路遥	林达	夫妻
金岳霖	梁思成	好友
蒋丽莎	陈浩民	夫妻
张爱玲	胡兰成	夫妻
李润杰	张志宽	师生
余思敏	郑中基	夫妻
谢军	吴少彬	夫妻
黄小琥	蔡依林	同门
杨紫琼	让·托德	夫妻
李树建	李健	师生
狄更斯	约翰·狄更斯	父母
奥尼尔	詹姆斯	合作
麦嘉轩	麦嘉殷	兄弟姐妹
何怡贞	何泽瑛	兄弟姐妹
秦可卿	贾蓉	夫妻
马宗慧	金碧艳	亲戚
熊向晖	谌筱华	夫妻
王玉璞	王晶华	兄弟姐妹
田雨	王玥	夫妻
黄月英	诸葛尚	祖孙
郭得胜	郭炳湘	父母
王政君	刘骜	父母
金庸	查传倜	父母
郭台铭	郭台强	兄弟姐妹
王文林	郭德纲	合作
夏美珍	松雪芳	父母
高盛麟	刘砚芳	父母
苍井空	麦浚龙	情侣
洪煦榆	洪天照	兄弟姐妹
马一浮	汤寿潜	父母
袁克定	袁克文	兄弟姐妹
李嫣	李亚鹏	父母
刘家辉	刘湛	父母
潘长江	赵本山	好友
周一良	陈寅恪	师生
刘文辉	刘湘	亲戚
徐玉华	徐玉峰	兄弟姐妹
李宣捷	王馨苹	合作
成龙	于占元	父母
陶希圣	高宗武	好友
朱希祖	章太炎	师生
杨秀清	萧朝贵	兄弟姐妹
侯喜瑞	尚小云	合作
傅彦	彭真	父母
何猷佳	梁安琪	父母
罗德丞	罗文锦	父母
侯宝林	刘宝瑞	合作
冯宝华	田立禾	合作
凯特·哈德森	Hudson	父母
安乐公主	韦后	父母
佘太君	杨业	夫妻
张琼姿	郭泰源	夫妻
汪圆圆	方振文	情侣
黄桂秋	言菊朋	合作
张德福	陈胜利	师生
甘婷婷	吴奇隆	合作
伍绍祖	熊天荆	父母
叶挺	贺敏学	亲戚
宋世德	宋铁麟	父母
顺治	恭靖妃	夫妻
荣格	弗洛伊德	合作
林翠	王馨平	父母
任之恭	陶葆柽	夫妻
赖俊健	曾明娜	父母
程永华	汪婉	夫妻
安志杰	李玟	情侣
周建人	羽太信子	兄弟姐妹
三浦贵大	三浦佑太郎	兄弟姐妹
师胜杰	师世元	父母
孔令辉	马苏	情侣
卢汉	龙泽汇	兄弟姐妹
郭全宝	于俊波	师生
周星驰	于文凤	情侣
路遥	路茗茗	父母
黄宗洛	黄宗英	兄弟姐妹
侯玉兰	李少春	夫妻
关学曾	关少曾	父母
吴湖帆	陈子清	兄弟姐妹
张世良	张承中	父母
蓝心湄	蓝宜慧	亲戚
金正男	张成泽	亲戚
雅克·罗格	萨马兰奇	情侣
蒋介石	蒋孝勇	祖孙
孙玥	孙锦华	父母
陈自瑶	王浩信	情侣
郭泰源	郭义煌	兄弟姐妹
黄晓娟	赵本山	合作
吴松岩	吴钰璋	父母
扈三娘	祝彪	夫妻
洪欣	莫少聪	情侣
张小燕	贝镇坤	夫妻
顾颉刚	叶圣陶	同门
曹休	曹操	上下级
李世霖	李乐亭	父母
江欣燕	吴积逊	夫妻
田不易	苏茹	夫妻
常振芳	张其维	师生
李海泉	李振辉	父母
孙亮	孙权	父母
托勒密十三世	托勒密十二世	父母
大枝雄介	杨嘉源	师生
黄希庭	吕厚超	合作
朱德刚	刘增锴	合作
费孝通	孟吟	夫妻
沙孟海	沙更世	父母
曹真	秦邵	父母
代善	阿巴泰	兄弟姐妹
周一良	邓懿	夫妻
亚历山大·仲马	亚历山大·仲马	父母
李淑媛	李万春	父母
成龙	洪金宝	同门
傅全香	薛莺	师生
张绣	张泉	父母
侯耀文	侯宝林	父母
唐老鸭	史高治	亲戚
曾肇	曾巩	兄弟姐妹
吴征镒	吴征鉴	兄弟姐妹
张恭庆	张佩纶	祖孙
陆定一	严慰冰	夫妻
张东健	廉静儿	情侣
周芷若	丁敏君	同门
冯子洋	孙彦波	同门
陈勋奇	叶倩文	合作
洪虎	张文	父母
岸川圣也	水谷隼	合作
虞梦	李虹	父母
徐弘	徐弢	兄弟姐妹
郭少衡	翀岳	父母
鲁健	郑天亮	夫妻
曹爽	夏侯玄	兄弟姐妹
李宗伟	黄妙珠	情侣
霍震宇	霍英东	父母
林慧萍	潘博照	夫妻
原田淑人	白鸟库吉	师生
古晨	孙悦	情侣
吴玠	吴扆	父母
陆雪琪	田不易	师生
连方瑀	连战	夫妻
赛义夫·伊斯兰	卡扎菲	父母
慕容德	公孙氏	父母
钟少珍	杨景辉	师生
沮渠蒙逊	沮渠苟生	兄弟姐妹
陶斯亮	陶铸	父母
张伟欣	李小璐	父母
李永波	龚智超	师生
张活游	楚原	父母
王耀武	郑宜兰	夫妻
伏羲	华胥	父母
杜义德	刘伯承	上下级
符光耿	欧阳英	师生
汪桂芬	孙菊仙	合作
欧阳锋	欧阳克	父母
罗明珠	袁洁莹	合作
许地山	周俟松	夫妻
常宝丰	常宝霆	兄弟姐妹
尼尔·阿姆斯特朗	迈克尔·柯林斯	合作
金月楼	筱灵凤	合作
虎美玲	常香玉	师生
木吒	哪吒	兄弟姐妹
钱慧韵	赖国友	师生
汤一介	乐黛云	夫妻
孔令文	孔祥明	父母
林豆豆	林彪	父母
郭沫若	郭和夫	父母
皮帕·米德尔顿	威廉王子	兄弟姐妹
叶绍德	方文正	师生
叶盛兰	刘淑卿	夫妻
唐代宗	李连	父母
姚玉芙	梅兰芳	合作
钱复	钱鸿业	祖孙
关德兴	扎脚胜	父母
恬妞	叶聪豪	夫妻
刘胡兰	刘景谦	父母
里根	Neil	兄弟姐妹
黎志康	徐静斐	父母
道光	孝全成皇后钮祜禄氏	夫妻
章子男	章子怡	兄弟姐妹
白雪仙	冯峰	合作
李兆楠	李兆基	兄弟姐妹
伍云甫	熊天荆	夫妻
英壮	英达	兄弟姐妹
康熙	胤祎	父母
方苞	刘大櫆	师生
马三立	侯宝林	师生
钱壮飞	钱一平	父母
慕容翰	慕容廆	父母
赵景勃	赵景浩	兄弟姐妹
赵灵儿	李逍遥	夫妻
海瑞	海翰	父母
伊达政宗	田村清显	父母
戈培尔	希特勒	上下级
秦钟	秦可卿	兄弟姐妹
邓爱嘉	张淑仪	父母
陈致中	吴淑珍	父母
孙毓敏	赵荣琛	合作
陈莲笙	庆	父母
威廉王子	戴安娜	父母
黄月英	诸葛京	祖孙
蒋友青	蒋友常	兄弟姐妹
郑曼青	宋幼庵	师生
李欧梵	李玉莹	夫妻
爱德华五世	约克公爵理查	兄弟姐妹
冯允庄	尹桂芳	合作
李兆基	李家诚	父母
莫里斯·皮特森	乔纳森·本德尔	兄弟姐妹
林明珠	林百欣	父母
马季	马东	父母
马艳丽	郎昆	夫妻
姜铁麟	李万春	师生
樊枫	邓少峰	师生
彭雪枫	彭小枫	父母
董昭	董胄	父母
章子男	殷旭	夫妻
张静江	张定甫	父母
灵宝天尊	元始天尊	师生
罗美薇	袁洁莹	合作
比尔·盖茨	Gates	父母
关羽	关凤	父母
黄长发	李姿霆	情侣
侯丹梅	关肃霜	师生
筱丹桂	徐玉兰	合作
郭守敬	张文谦	合作
崔世安	崔世昌	兄弟姐妹
宋耀如	倪桂珍	夫妻
刘烨	谢娜	情侣
许世勋	许歧伯	兄弟姐妹
莎士比亚	苏珊娜	父母
崔建邦	邝敏慧	情侣
张云标	高兴荣	师生
俞岱岩	张翠山	同门
白雪仙	薛家燕	师生
叶小纲	叶纯之	父母
董存瑞	孙珍	父母
陈仲山	陈青远	父母
王个簃	陈师曾	好友
格罗弗·克利夫兰	鲁思·克利夫兰	父母
卫若兰	史湘云	夫妻
李泳豪	杨思琦	情侣
海岩	侣皓吉吉	父母
石祥	铁源	合作
达莉亚·索托	卡斯特罗	夫妻
梁思懿	梁思宁	兄弟姐妹
茹志娟	王安忆	父母
虚竹	天山童姥	师生
庄姜	卫庄公	夫妻
林黛	龙绳勋	夫妻
何念慈	孙莹莹	父母
卢汉	龙云	兄弟姐妹
陈勋奇	王家卫	上下级
宋美龄	宋嘉树	父母
孙悟空	唐僧	师生
蒋百里	查品珍	夫妻
朱棣文	吉恩	夫妻
刘伯坚	秦德君	情侣
毛利兰	工藤新一	情侣
赵崇基	郑则仕	好友
陈玉莲	陈超武	夫妻
阮若珊	黄宗江	夫妻
李克农	赵瑛	夫妻
筱文滨	小筱月珍	合作
林丹	李永波	师生
吴鉴泉	吴英华	父母
尤浩然	李静	父母
谢晋	谢衍	父母
玄彬	成宥利	情侣
欧阳菲菲	式场壮吉	夫妻
马敬伯	马三立	亲戚
周蜜	唐学华	师生
陈冠希	陈见飞	兄弟姐妹
汪小菲	吕婉柔	情侣
李敏	孔令华	夫妻
王石	王江穗	夫妻
叶步青	梁相	同门
魏春荣	乔燕	师生
阎晶晶	阎维文	父母
句号	郭雅丹	夫妻
吴承瑛	顾玮	夫妻
王海祥	成龙	师生
张博宇	吕丽萍	父母
廉月儒	华廉仲	师生
洪学智	杨得志	合作
周正龙	罗大翠	夫妻
李菁	于谦	同门
慕容超	慕容德	亲戚
金范	金俊	好友
金平日	金仁江	父母
唐太宗	唐高宗	父母
孙琳琳	赵晓兵	师生
贾代善	贾赦	父母
麦凯恩	詹姆士	父母
王蕙芳	王攀桂	祖孙
陈文新	陈昌	父母
杨受成	杨其龙	父母
夏绍范	夏明翰	父母
王小波	王小平	兄弟姐妹
康万生	宋美福	夫妻
李德伦	贺绿汀	合作
包伟铭	包庭政	父母
英如镝	英达	父母
林佳楣	李先念	夫妻
刘湘	刘文刚	父母
谭富英	谭元寿	父母
董维贤	徐斌寿	师生
陈赓	谭政	兄弟姐妹
赵婷婷	郑波	合作
汤君年	汤珈铖	父母
成昆	张无忌	师生
小小彬	迷你彬	兄弟姐妹
李怡	唐宪宗	父母
钱三强	钱玄同	父母
房仕胜	成龙	兄弟姐妹
徐艳琴	马金凤	合作
张宗昌	袁中娥	夫妻
小盖叫天	盖叫天	父母
李苦禅	李慧文	夫妻
陈金雀	陈寿峰	父母
徐玉华	徐洪春	父母
陈品亨	陈秉升	兄弟姐妹
爱新觉罗·胤禄	雍正帝	兄弟姐妹
王又曾	王简文	父母
袁承志	夏雪宜	父母
蒋翼遥	鞠萍	父母
刘仲容	刘承烈	父母
霍英东	林淑端	夫妻
戴娆	谢东	情侣
白凤鸣	白凤岩	兄弟姐妹
刘云天	郭德纲	师生
陈懿	柳海澄	夫妻
杨国强	杨艳池	夫妻
陈英杰	陈贤民	亲戚
寇永昌	王澜华	夫妻
水月	陆雪琪	师生
陶菲克	阿咪·古迈拉尔于	夫妻
马莉莉	凌爱珍	合作
高英姬	金正日	夫妻
保罗·萨缪尔森	罗伯特·萨缪尔森	兄弟姐妹
赵子龙	赵统	父母
李婷宜	李婷芷	兄弟姐妹
唐鉴军	赵本山	师生
宋时轮	叶剑英	合作
花淑兰	伟	师生
叶群	林彪	夫妻
章小蕙	陈曜旻	情侣
邓拓	丁一岚	夫妻
蔡依珊	连惠心	亲戚
金日成	金正淑	夫妻
容星桥	容闳	兄弟姐妹
艾青	艾轩	父母
关伯威	张冰茜	夫妻
江上青	江石溪	父母
李冰冰	朱孝天	情侣
肯尼迪	杰奎琳	夫妻
牛剑锋	刘志强	夫妻
程丽莎	郭晓冬	夫妻
林晓霖	张梅	父母
黄玉莹	冯辅庄	夫妻
小林觉	孔令文	父母
蒋方良	蒋孝章	父母
孙甫亭	王晓临	师生
冯默风	黄药师	师生
孙中山	宋庆龄	夫妻
佐藤荣作	信介	兄弟姐妹
袁洁莹	罗美薇	合作
加里·佩顿	莫尼奇	夫妻
木村拓哉	木村心美	父母
文嘉	文徵明	父母
吉川元春	小早川隆景	兄弟姐妹
赵伟洲	谢天顺	合作
吴江秋	王瑶卿	师生
战殊	战福章	父母
赵晨浩	章子怡	好友
谢振南	谢霆锋	父母
张宝英	崔兰田	师生
方声洞	方声涛	兄弟姐妹
杜淳	杨璐	情侣
赵忠尧	赵维仁	父母
金月楼	金佩楼	兄弟姐妹
周星驰	莫文蔚	情侣
尤小刚	邬靖靖	亲戚
邹市明	冉莹颖	夫妻
李民斌	李国宝	父母
王文澜	倪萍	夫妻
侯君集	李靖	合作
吕丽萍	张博宇	父母
林肯	爱德华·贝克·林肯	父母
韩布新	张腾霄	师生
宋美龄	蒋经国	父母
曹棘	曹操	父母
内纳德·科斯蒂奇	杰夫·格林	合作
梁伯熙	童辉	师生
连方瑀	蔡依珊	父母
赵昆	赵惠民	祖孙
王菲	李亚鹏	夫妻
桑兰	黄健	情侣
邵力子	邵伟志	父母
三毛	王洛宾	好友
林肯	罗伯特	父母
怪兽	五月天	合作
咸丰	云嫔武佳氏	夫妻
克莱德·德雷克斯勒	约翰·帕克森	合作
陈泮岭	李存义	师生
贾代化	贾敷	父母
林青霞	秦祥林	情侣
赵云	张飞	合作
张澜	张茂延	父母
顺治	康熙	父母
邓伟	朱光潜	师生
成吉思汗	窝阔台	父母
沈春阳	小沈阳	夫妻
李光弼	郭子仪	好友
李嘉欣	许世勋	父母
卡卡	伊莎贝拉	父母
齐白石	齐可来	祖孙
郭荣起	赵佩茹	合作
荀攸	荀適	父母
白玉梅	白玉玲	师生
何鸿燊	何福	祖孙
埃里克·克拉普顿	Clapton	父母
茹富兰	叶盛兰	师生
李艳芳	赵瑞花	合作
周启生	周永恒	亲戚
解丰鸣	毛阿敏	父母
贺玉钦	陈永玲	合作
傅斯年	傅淦	祖孙
蒙奇·D·路飞	乌索普	合作
胡为真	叶霞翟	父母
张桂凤	费禄姣	师生
林孝贤	谢玲玲	父母
孙中山	大月薰	夫妻
齐秦	方美芳	父母
吴冰	冰心	父母
姜大卫	尔冬升	兄弟姐妹
严珊珊	黎民伟	夫妻
范曾	张桂云	夫妻
宋逸民	张庭	情侣
马拉多纳	达尔马·内莱亚·马拉多纳	父母
宋青书	宋远桥	父母
刘翔	孙海平	师生
周文王	毕公高	父母
波塞冬	瑞亚	父母
郑亚旗	郑洪升	祖孙
张学友	黎明	好友
巩俐	巩力泽	父母
言承旭	吴建豪	合作
姜维	诸葛亮	师生
荀子	李斯	师生
严凯泰	严庆龄	父母
王政君	刘奭	夫妻
奚啸伯	言菊朋	师生
张寿臣	常宝堃	师生
倪桂珍	宋子文	父母
孙淳	孙周	兄弟姐妹
霍震寰	霍启文	父母
侯喜瑞	荀慧生	合作
王怡仁	张育汉	情侣
金月楼	蔡玉莲	合作
孙虑	顾雍	合作
张曼玉	成龙	情侣
毛利元就	幸松丸	亲戚
邝美云	吕良伟	夫妻
黎洪模	黎枫	父母
于文凤	戴维	兄弟姐妹
翁美玲	汤镇业	情侣
伏明霞	伏明天	兄弟姐妹
大乔	周瑜	兄弟姐妹
李金	李阳	夫妻
李叔同	夏丏尊	好友
戚美珍	苗彤	父母
曹丕	曹霖	父母
王刚	张铁林	好友
王世襄	王继曾	父母
廖梦醒	廖仲恺	父母
徐伯阳	徐悲鸿	父母
班婕妤	汉成帝	夫妻
谷超豪	苏步青	师生
许世勋	李嘉欣	父母
钱永健	钱学森	亲戚
于俊波	郭全宝	师生
骆连翔	方荣翔	师生
福坪安	吴鹤龄	师生
包小柏	包小松	兄弟姐妹
曹干	曹操	父母
谭韵寿	谭富英	父母
赵薇	赵家海	父母
小岚云	刘宝全	合作
赵济羹	程祥林	师生
骆玉笙	王冠丽	师生
李仕凡	李华得	父母
曹禺	万德尊	父母
于俊波	白宝事	同门
田连章	田荫亭	亲戚
阎振俗	乔慷慨	师生
张翠山	殷素素	夫妻
苗人凤	苗若兰	父母
秋瑾	王灿芝	父母
亨利五世	凯瑟琳	夫妻
郭台强	郭台铭	兄弟姐妹
何东	何启福	兄弟姐妹
姚沁蕾	姚志源	祖孙
罗东进	罗荣桓	父母
安室奈美惠	Sam	夫妻
曹勤	曹操	父母
王世襄	袁荃猷	夫妻
周洋	孙琳琳	合作
黎洪模	徐静斐	夫妻
梁元帝	萧纪	兄弟姐妹
陈志朋	吴奇隆	合作
田不易	宋大仁	师生
叶天士	叶时	祖孙
关之琳	马清伟	情侣
戴季陶	戴家祥	父母
胡适	梁实秋	好友
高英姬	金正恩	父母
钱仲联	钱振伦	祖孙
恩晓峰	姜春桂	夫妻
周璇	周伟	父母
陈山聪	何超云	情侣
邓肇坚	邓永锵	祖孙
朱邦造	陈立春	夫妻
孙胜男	孙春来	父母
夏绍范	陈云凤	夫妻
魏海敏	梅葆玖	师生
金秀山	郎德山	师生
王刚	郑艳东	夫妻
金正哲	高英姬	父母
张学友	罗美薇	夫妻
钱三强	邓稼先	合作
卞之琳	徐志摩	师生
张长青	柳岩	好友
郭槐	贾午	父母
郭晶晶	周继红	师生
十六夜	犬夜叉	父母
王玉璞	崔红	师生
颛顼	穷蝉	父母
张柏芝	陈晓东	情侣
夏明翰	陈云凤	父母
田震	许巍	好友
关肃霜	李丽	师生
毛远新	毛泽民	父母
薛艳君	靳艳玲	合作
孙燕姿	李偲菘	师生
顾颉刚	张静秋	夫妻
赵钩弋	汉武帝	夫妻
吴祖光	新凤霞	夫妻
马樟花	陆根棣	上下级
成龙	房道龙	父母
和田清	加藤繁	同门
王传一	申东靖	合作
陈撄宁	张竹铭	师生
杨振铭	杨澄甫	父母
张晋	蔡少芬	夫妻
李肇星	秦晓梅	夫妻
傅作义	傅冬菊	父母
林子祥	林德信	父母
李世民	长孙无忌	兄弟姐妹
陈梦	曹丽思	合作
Avril	Lavigne	兄弟姐妹
孙皓	孙权	祖孙
毛泽东	邓小平	合作
钟鸣岐	杨荣环	合作
钟小江	刘若英	夫妻
黄昆	黄宣	兄弟姐妹
戚雅仙	周雅琴	师生
理查德·加里奥特	欧文·加里奥特	父母
任冰儿	任剑辉	兄弟姐妹
梁伯熙	李宏平	师生
曹其敏	刘英华	合作
叶明子	叶选廉	父母
赵朴初	赵文楷	亲戚
日向宁次	鸣人	好友
殷离	殷素素	亲戚
王勃	王通	祖孙
邢岫烟	邢夫人	亲戚
吴卓羲	张馨予	情侣
陈延年	陈鹤年	兄弟姐妹
新艳秋	王海山	父母
梅德韦杰夫	梅德韦杰娃	夫妻
爱德华二世	爱德华三世	父母
竺小招	陶琪	合作
钱金福	余叔岩	师生
彭雪枫	林颖	夫妻
黎姿	黎民伟	祖孙
王采玉	蒋肇聪	夫妻
张有兴	张天爱	父母
詹姆斯	奥尼尔	合作
费英东	舒尔哈齐	合作
刘家良	黄杏秀	师生
韩婷婷	范瑞娟	师生
丁谓	丁守节	祖孙
唐高宗	武则天	夫妻
于七	于景元	师生
何东	张莲觉	夫妻
斯嘉丽·约翰逊	卡斯坦·约翰逊	父母
金铁霖	马秋华	夫妻
三毛	陈嗣庆	父母
周洋	刘鹏飞	兄弟姐妹
贾廷聚	胡希华	合作
迭戈·弗兰	巴勃罗·弗兰	父母
褒姒	伯服	父母
任剑辉	龙剑笙	师生
蔡少芬	蔡少雄	兄弟姐妹
王耀武	王鲁美	父母
赵兰坤	连震东	夫妻
吴健	李维格	上下级
邓丽君	赵素桂	父母
李赋京	李仪祉	亲戚
翟志刚	翟志强	兄弟姐妹
李菁	贾建国	父母
范紫东	范文驹	父母
陈楚河	陈启礼	父母
朱阔泉	朱蒋氏	夫妻
张留孙	张闻诗	亲戚
程继仙	叶盛兰	师生
布鲁诺·阿尔维斯	华盛顿·阿尔维斯	父母
沈健谨	沈金波	父母
黄遵宪	李鸿章	合作
蒙毅	蒙武	父母
英壮	英宁	兄弟姐妹
王庾生	李宗义	师生
庄月明	李嘉诚	夫妻
林则徐	林普晴	父母
李宗盛	朱卫茵	夫妻
薛艳君	李凤梧	合作
范小宁	范圣琦	亲戚
毛远新	方志纯	父母
贾琏	平儿	夫妻
顾顺章	钱壮飞	好友
李先念	林佳楣	夫妻
马拉多纳	吉安娜·迪诺拉·马拉多纳	父母
贾谊	梁怀王	师生
辛笛	钱钟书	同门
何智辉	王素筠	夫妻
唐鉴军	王小华	夫妻
李伯培	张荣培	师生
俞启威	俞明震	祖孙
瞿秋白	杨之华	夫妻
冯宝华	魏文华	合作
文千岁	黄浩棉	同门
赵佩茹	常贵田	师生
叶飞	陆一婵	夫妻
苗文华	桑振君	师生
林芳锦	筱芳锦	亲戚
谷文月	喜彩莲	师生
刘琼	刘本之	父母
格蕾丝·凯利	斯蒂芬妮	父母
朱林瑶	林国文	夫妻
封至模	陈幼韩	师生
朱嘉琛	黄宗江	夫妻
田娃	刘殿才	师生
袁世海	吴彦衡	师生
周海婴	田中正道	父母
宗毓华	傅履仁	兄弟姐妹
科比	乔·布莱恩特	父母
杜鲁门	玛丽·简·杜鲁门	兄弟姐妹
郭全宝	白全福	合作
丁至云	魏方莲	师生
马时亨	王培琪	夫妻
王治郅	任焕贞	父母
苏海文	包陪庆	夫妻
道光	寿臧和硕公主	夫妻
马晓春	许燕	夫妻
戴季陶	蒋纬国	父母
章士钊	殷德珍	夫妻
丘吉尔	珍妮·杰罗姆	父母
廖仲恺	许崇清	亲戚
徐宗汉	李庆春	父母
赵学义	阎秋霞	师生
樊枫	张华	师生
安藤武夫	伊藤友惠	师生
洪秀全	洪仁发	兄弟姐妹
霍元甲	霍元栋	兄弟姐妹
瞿同祖	赵曾玖	夫妻
小泉纯一郎	小泉由兵卫	祖孙
马鸿逵	马敦静	父母
周海婴	周景轩	祖孙
梁启超	王桂荃	夫妻
叶步青	招允	同门
赵孟頫	管道升	夫妻
陈锐	茅海童	夫妻
黄君璧	徐悲鸿	好友
杨澄甫	杨振铎	父母
傅希如	倪海天	师生
张琴秋	张玛娅	父母
马鸿宾	马普仁	父母
蒋碧微	徐悲鸿	夫妻
连方瑀	连惠心	父母
瞿颖	张亚东	情侣
靓元亨	关德兴	师生
曾山	曾延生	兄弟姐妹
李国静	杨荣环	师生
赖斯翔	Ella	情侣
陈立夫	陈其美	亲戚
蔡尚思	王国维	师生
麒麟童	周少麟	父母
张国立	张默	父母
朱挺	董方卓	合作
郭沫若	于立群	夫妻
罗素	康拉德·罗素	父母
郭跃	刘诗雯	合作
宋子安	宋伯熊	父母
鸠山由纪夫	鸠山邦夫	兄弟姐妹
蒋才如	吴企善	合作
邱爱伦	蒋孝刚	父母
陈玉成	石达开	合作
司棋	潘又安	情侣
陈法蓉	倪震	情侣
秦叔宝	李世民	上下级
陈国邦	罗敏庄	夫妻
宋任穷	钟月林	夫妻
蒋碧微	徐静斐	父母
李光洁	郝蕾	夫妻
沈周	沈恒吉	父母
韩信	萧何	合作
宋达泉	侯光炯	合作
筱丹桂	张春帆	上下级
沈世启	缪传先	师生
杨蕾	戴志诚	夫妻
张居正	张敬修	父母
马步青	马麒	父母
王琴侬	王世续	父母
黄宗淮	黄宗洛	兄弟姐妹
黄昆	黄宛	兄弟姐妹
周先庚	陈立	合作
范雯	黄旭	夫妻
严珊珊	严浩波	父母
关德兴	靓元亨	师生
张居正	张嗣修	父母
吴征镒	吴征铠	兄弟姐妹
黄宗洛	黄宗江	兄弟姐妹
尹志强	梁汉文	亲戚
田卿	赵芸蕾	合作
王耀武	王鲁云	父母
茅盾	沈雷	父母
丰臣秀次	丰臣秀吉	父母
王金平	王馨敏	父母
邓世昌	邓立英	祖孙
慕容博	慕容复	父母
张飞	关羽	兄弟姐妹
刘琮	刘表	父母
李秀明	谢晋	师生
何香凝	廖仲恺	夫妻
李新兰	李砚秀	父母
笑林	刘司昌	师生
毛泽东	朱德	合作
刘允斌	刘少奇	父母
宋庆龄	孔祥熙	兄弟姐妹
苏志威	蔡一智	兄弟姐妹
朱颖文	周意男	夫妻
许德珩	邓稼先	父母
傅娟	欧阳龙	夫妻
包小松	包庭政	亲戚
王璐瑶	路瑰迎	父母
周侗	武松	师生
卡扎菲	赛义夫·伊斯拉姆·卡扎菲	父母
范旭霞	朱时茂	夫妻
杨国强	杨惠妍	父母
王丽卿	姚玉芙	兄弟姐妹
田连章	田起山	父母
少女时代	李顺圭	合作
陈潭秋	徐全直	夫妻
黄宗英	异方	夫妻
皮特·克劳奇	阿比·克兰茜	夫妻
吉拉迪诺	阿利切	夫妻
成惠琳	金正男	父母
张默	叶璇	情侣
武丁	盘庚	亲戚
吴舜文	严凯泰	父母
严景耀	雷洁琼	夫妻
梅兰芳	杜近芳	师生
贾南风	司马衷	夫妻
陈照奎	陈发科	父母
胡传	胡适	父母
陈赫	胡小玲	父母
李豫	唐肃宗	父母
杨振基	杨振铭	兄弟姐妹
包玉刚	吴光正	父母
杰里·巴斯	珍妮·巴斯	父母
李吉瑞	尚和玉	合作
徐玉华	吴宗兰	父母
马诗慧	王敏德	夫妻
宋奕萱	宋锋	父母
叶明子	叶剑英	祖孙
舒昌玉	魏莲芳	同门
陆云	陆机	兄弟姐妹
班德贵	范振钰	师生
孙明珠	赵燕侠	合作
刘遵义	于右任	祖孙
允浩	吴尊	好友
邓朴方	邓小平	父母
普密蓬·阿杜德	父	父母
连胜文	连战	父母
廖凤舒	李少石	亲戚
辽太祖	耶律倍	父母
潘阳	潘长江	父母
汪小菲	田益宾	父母
潘雨辰	侯勇	夫妻
白玉梅	小白玉梅	父母
续范亭	穆青	父母
黄永玉	张梅溪	夫妻
马彦祥	云燕铭	夫妻
苏妙玲	段林希	好友
卢恬儿	霍启刚	情侣
裘桂仙	何桂山	师生
潘石屹	张欣	夫妻
何伟凌	何非凡	亲戚
谭娜	谭世秀	祖孙
常宝华	傅天真	夫妻
九灵元圣	黄狮精	师生
贾樟柯	朱炯	夫妻
曹锟	郑氏	夫妻
阿奴	南蛮王	父母
姚凤丝	苗侨伟	情侣
亚伯拉罕·林肯	罗伯特·托德·林肯	父母
郝艳霞	郝英吉	父母
罗微	李来	夫妻
汤姆·克鲁斯	妮可·基德曼	夫妻
谭世秀	李秀玲	夫妻
金少梅	时小福	师生
葛晓洁	文洁	父母
常书鸿	陈芝秀	夫妻
瞿同祖	吴文藻	师生
小椋久美子	潮田玲子	合作
梅婷	鄢颇	夫妻
李纨	贾兰	父母
郑弘	钱琳琳	夫妻
黄兴	薛君度	父母
张斌	胡紫薇	夫妻
张成泽	金日成	父母
郎德山	金秀山	师生
孙悦	朱芳雨	合作
刘爱琴	刘允斌	兄弟姐妹
高雪樵	高月秋	兄弟姐妹
蹇先任	蹇先为	兄弟姐妹
田荫亭	田亚亭	兄弟姐妹
李念	林和平	夫妻
傅履仁	宗毓华	兄弟姐妹
谭凤元	刘宝全	师生
冯牧	冯承钧	父母
朱双喜	吴芷茵	师生
刘伯玲	赵贞玉	同门
连惠心	连方瑀	父母
张静江	张石铭	兄弟姐妹
袁雪芬	马樟花	合作
李谷一	肖一	父母
华少	秦利鸽	夫妻
孙玉奎	孙寿斋	父母
罗章龙	陈独秀	好友
原田淑人	池内宏	同门
马三立	马志良	父母
刘玄	刘子张	父母
林珍奇	李依琳	父母
孔祥熙	宋子文	兄弟姐妹
关灵凤	樊粹庭	合作
王洁	李家新	师生
徐静斐	徐伯阳	兄弟姐妹
薛蝌	邢岫烟	夫妻
李俊毅	王丽情	夫妻
陈凤芸	黄铁良	夫妻
黄百禄	陈致中	父母
侯宝林	侯耀文	父母
阿劳	洛伦佐·德·阿劳	亲戚
欧锦棠	万斯敏	夫妻
徐媛媛	叶江川	师生
张美娟	小张美娟	师生
池尚昱	李会昌	好友
庄佳容	庄岳颖	兄弟姐妹
薄熙永	薄洁莹	兄弟姐妹
孔从洲	孔继宁	祖孙
晋惠帝	始平公主	父母
杭子和	沈宝钧	师生
刘虹	张阜新	师生
邓绥	邓禹	祖孙
范竞马	沈湘	师生
孙禄堂	程廷华	师生
周兆明	范玉梅	夫妻
解植坤	解丰鸣	父母
安倍晋太郎	安倍晋三	父母
辽景宗	辽圣宗耶律隆绪	父母
刘大櫆	姚鼐	师生
赵薇	黄有龙	夫妻
田益宾	汪小菲	父母
寇准	魏野	好友
莲小君	爱莲君	师生
潘迪生	杨紫琼	夫妻
洪金宝	曹恩玉	夫妻
郭艾伦	郭士强	亲戚
Ella	Selina	合作
金仲仁	王维秋	师生
王夫人	贾珠	父母
程颐	谢良佐	师生
元彪	元楼	合作
范小宁	李玉刚	情侣
裴永利	裴海泉	祖孙
萨达姆	Rana	父母
茹志娟	汪祖荣	同门
张镇芳	张致远	祖孙
拿破仑	玛丽·路易莎	夫妻
李克农	胡底	合作
王选	柳传志	好友
成龙	元彪	同门
吴卫凤	赵治山	夫妻
卓文君	卓王孙	父母
尹恩惠	金钟国	情侣
郭襄	郭破虏	兄弟姐妹
水均益	水亦诗	父母
陈散原	陈寅恪	父母
奥巴马	安·邓纳姆	父母
高百岁	郭玉昆	合作
侯军	侯瓒	兄弟姐妹
毛泽东	刘少奇	合作
余胜荪	余三胜	祖孙
南成哲	李光川	合作
侯喜瑞	程砚秋	合作
朱武	陈达	合作
松本刚明	紫藤一郎	兄弟姐妹
王婉华	张慧芳	师生
徐邦达	滕芳	夫妻
何雯娜	陈一冰	情侣
手冢国光	手冢国晴	父母
钱惠丽	方亚芬	合作
翟志刚	张淑静	夫妻
加内特	奥尼尔	合作
吴全德	吴甘霖	父母
温斯顿·丘吉尔	伦道夫·丘吉尔	父母
张治中	张素我	父母
林佳楣	李紫阳	父母
纳丹	乌尔米拉	夫妻
徐子淇	李兆基	父母
黄宏	段小洁	夫妻
郭全宝	王少云	师生
田起山	田荫亭	兄弟姐妹
徐峥	陶虹	夫妻
查传倜	金庸	父母
谢侠逊	谢公出	父母
成龙	房仕胜	兄弟姐妹
胡荣华	何顺安	师生
陈乔年	陈独秀	父母
傅起凤	傅天正	父母
程思远	程华	父母
章含之	乔冠华	夫妻
谈杨	杨旭	合作
杜鲁门	约翰·维维安·杜鲁门	兄弟姐妹
宋丹丹	赵玉吉	夫妻
汉昭帝	汉武帝	父母
宋蔼龄	蒋介石	兄弟姐妹
山口百惠	三浦友和	夫妻
奥尼尔	加内特	合作
白岩松	白清扬	父母
刘春慧	张文霞	师生
巴克利	奥拉朱	合作
孙策	孙翊	兄弟姐妹
灰娃	张仃	夫妻
尉迟恭	李世民	上下级
张玉	韦唯	父母
范泽林	沈汉生	师生
蒋璐霞	赵文卓	同门
冯远征	梁丹妮	夫妻
贺龙	萧克	兄弟姐妹
宗天意	罗启仁	父母
裘桂仙	裘盛戎	父母
大乔	乔国老	父母
傅聪	傅雷	父母
徐静斐	徐悲鸿	父母
霍慧芬	霍英东	亲戚
蒋才如	杨思远	合作
辛晓琪	马景涛	兄弟姐妹
赖亚文	刘国军	夫妻
筱文滨	邵滨孙	合作
杨过	杨康	父母
吴佳多	吴小明	父母
牛玉儒	谢莉	夫妻
爱因斯坦	Einstein	祖孙
拖雷	忽必烈	父母
谢天华	郭富城	同门
符光耿	许起华	夫妻
潘粤明	董洁	夫妻
成龙	房仕德	兄弟姐妹
贾政	贾珠	父母
奚啸伯	欧阳中石	师生
艾森豪威尔	玛丽·吉瓦尼·杜德	夫妻
陈彦衡	陈富年	父母
段誉	刀白凤	父母
秦孝公	秦献公	父母
寒春	阳早	夫妻
张美娟	赵京茹	师生
李盛泉	田金萍	师生
波比·肯	张雯婷	夫妻
杨化然	杨奇军	同门
金敏智	李信成	好友
冼夫人	冯宝	夫妻
朱玲玲	罗康瑞	夫妻
邵飘萍	汤修慧	夫妻
朱自清	武钟谦	夫妻
张子健	钱雁秋	同门
林忆莲	陈辉虹	情侣
陈世瑶	刘国梁	亲戚
黄子珈	赵胤胤	夫妻
陶湘如	张寿臣	合作
夏侯敦	夏侯廉	兄弟姐妹
王玉龄	孙立人	亲戚
韩婷婷	方亚芬	合作
王烁	范冰冰	情侣
毛泽覃	毛泽东	兄弟姐妹
燕姿	纳迪姆	夫妻
舒昌玉	王幼卿	师生
大枝雄介	安田泰敏	师生
周美青	马莉君	亲戚
曹颖	王斑	夫妻
杨澜	吴征	夫妻
林跃	郑小英	父母
梁锦松	伏明霞	夫妻
周吕鑫	周默	父母
释小龙	何洁	情侣
刘咏尧	刘若英	祖孙
何超莲	何超云	兄弟姐妹
周星驰	周文姬	兄弟姐妹
王学义	康有纯	师生
李斐莉雪	蓝道	情侣
陈佩斯	陈大愚	父母
何怡贞	钱三强	兄弟姐妹
官晶华	郑咏曦	父母
曾国藩	曾国葆	兄弟姐妹
廖镇汉	孙道存	父母
杨宪益	戴乃迭	夫妻
陈矫	陈粲	父母
李蓉芳	黄天麟	师生
刘靖基	刘丕基	兄弟姐妹
冯弘	冯邈	父母
袁世凯	袁克有	父母
陈毅	胡兰畦	好友
范伟	杨宝玲	夫妻
李伟建	武宾	合作
水谷隼	岸川圣也	合作
叶志铭	叶玉卿	兄弟姐妹
孙中山	卢慕贞	夫妻
关伯威	关世栋	父母
韩素音	唐保黄	夫妻
何超盈	梁安琪	父母
陈祖芬	刘梦溪	夫妻
关咏荷	张家辉	夫妻
郭睿玥	许美玲	师生
马世媛	唐韵	父母
阿姆斯特朗	凯伦	父母
冯巩	艾慧	夫妻
宋江	吴用	上下级
帕克	伊娃·朗格利亚	夫妻
浅野忠信	Chara	夫妻
葛晓洁	高凌风	父母
马小曼	燕守平	夫妻
李文华	姜昆	合作
张静江	陈友仁	父母
何猷龙	蓝琼缨	父母
王洁	田佳	合作
羊献容	羊玄之	父母
袁凤霞	桂宝芬	师生
张国庶	张国焘	兄弟姐妹
王玉蓉	王瑶卿	师生
乔峰	阿朱	夫妻
蒋友常	蒋友青	兄弟姐妹
孙正阳	关鸿宾	师生
新马师曾	邓祺	父母
刘邦	吕雉	夫妻
迈克尔·乔丹	马库斯·乔丹	父母
白崇禧	白先刚	父母
竺水招	尹桂芳	合作
刘金宝	丁燕生	上下级
巴乔	玛蒂尔德	父母
林美贞	孙恒	父母
吕大临	张载	师生
常东升	翁启修	师生
劳德诺	左冷禅	上下级
刘銮雄	蔡少芬	情侣
金孝渊	黄美英	合作
孙国豪	秦汉	父母
博尔特	Davis	祖孙
何泽慧	何怡贞	兄弟姐妹
徐静斐	徐庆平	兄弟姐妹
郭荣启	郭瑞林	父母
毛远新	朱丹华	父母
孙泰英	权相宇	夫妻
吴玠	吴拱	父母
周佳纳	周采茨	亲戚
李文华	郝爱民	合作
冯珏	冯友兰	祖孙
俞明震	俞珊	祖孙
董翠娜	张君秋	父母
陈清渊	陈清水	兄弟姐妹
解忧公主	岑陬	夫妻
刘大櫆	方苞	师生
薛君度	黄振华	兄弟姐妹
杜勤兰	管笑笑	父母
施闻	周嘉威	夫妻
陈德勋	陈兆熙	父母
徐静蕾	李亚鹏	情侣
吕良伟	杨小娟	夫妻
杨步伟	赵如兰	父母
陈泰	陈恂	父母
齐白石	齐平初	父母
贺龙	朱德	合作
单联丽	侯耀文	师生
甘少苏	钟树辉	夫妻
安德鲁·约翰逊	玛撒·约翰逊·帕特森	父母
包小松	包伟铭	兄弟姐妹
菩提祖师	孙悟空	师生
周希汉	周太安	父母
艾未未	艾青	父母
杨维	黄楠雁	合作
刘据	卫子夫	父母
杨宝森	谢虹雯	夫妻
黄绍竑	陈铭枢	好友
邱嘉雄	侯佩岑	父母
蔡依伦	林靖伦	夫妻
赵晨浩	范冰冰	好友
杨振铎	杨澄甫	父母
马世莉	马景涛	夫妻
李丞责	刘倩婷	情侣
喻传海	商芳臣	师生
冯轲	张靓颖	情侣
严凤英	严云高	师生
李长治	李嘉诚	祖孙
刘完素	张从正	师生
罗家宝	罗家会	亲戚
夏侯惇	夏侯廉	兄弟姐妹
于小伟	高圆圆	情侣
冯弘	慕容氏	夫妻
黄秋燕	李苔蜜	父母
何超仪	蓝琼缨	父母
田亮	田欣仪	父母
章士钊	章可	父母
骆玉笙	骆彩武	父母
王馨平	王美怡	兄弟姐妹
金少梅	孟小冬	合作
赵玉芳	汪洋	夫妻
老臭	刘丽	合作
李光弼	李楷洛	父母
黎洪模	承其刚	父母
田欣仪	叶一茜	父母
诸葛亮	诸葛瑾	兄弟姐妹
斛律金	斛律光	父母
亨利五世	玛丽·德·伯翰	父母
托尼·帕克	伊娃·朗格利亚	夫妻
吴法宪	陈绥圻	夫妻
谢东	马增蕙	父母
和田清	黄现璠	师生
安德鲁·约翰逊	小安德鲁·约翰逊	父母
杨颖	黄晓明	情侣
王佩英	张可心	父母
李蓉芳	王和霖	夫妻
藤原纪香	阵内智则	夫妻
袁日初	袁信义	兄弟姐妹
闻一多	闻铭	父母
孙志浩	孙文骐	父母
薛姨妈	贾政	兄弟姐妹
李纪周	程辛联	夫妻
王金璐	金少山	合作
吴征镒	吴筠孙	祖孙
斋藤道三	斋藤义龙	父母
祝允明	祝瓛	父母
袁承志	袁崇焕	父母
刘翠霞	新翠霞	师生
王敬之	姜宝明	师生
高锟	高吹万	祖孙
聂荣臻	聂力	父母
林立衡	林立果	兄弟姐妹
胡林翼	胡达源	父母
荀子	韩非	师生
蔡元培	王昭	夫妻
刘备	马超	上下级
白先勇	白崇禧	父母
哪吒三太子	托塔李天王	父母
王力宏	李明姝	父母
张宁	李永波	师生
杜琪峰	韦家辉	合作
丘吉尔	伦道夫	父母
醉丽君	武月华	师生
胡碧兰	王瑶卿	师生
嫘祖	黄帝	夫妻
贾琏	王熙凤	夫妻
门敢红	门惠丰	父母
尤三姐	尤二姐	兄弟姐妹
江珊	高曙光	夫妻
圣雄甘地	Gandhi	父母
谢婷婷	谢振南	亲戚
赵又廷	戴一瑜	父母
陈铭德	邓季惺	夫妻
关颖	蔡淑媛	父母
梅兰芳	尚小云	好友
谢亚龙	李益群	夫妻
赵子龙	张飞	合作
曹真	曹训	父母
南怀仁	汤若望	师生
杨威	杨云	夫妻
汤珈铖	汤君年	父母
叶璇	霍建华	好友
刘伯承	朱德	合作
严凤英	王冠亚	夫妻
籍薇	花五宝	师生
茅以升	戴传蕙	夫妻
翁美玲	黄日华	合作
谢婷婷	安志杰	情侣
陆锦娟	李蓉芳	合作
鲍莉	鲍蕾	兄弟姐妹
庄月明	庄静庵	父母
李秀成	杨秀清	合作
原子鏸	郑佩佩	父母
王映霞	钟贤道	夫妻
赵志刚	茅威涛	同门
王凤	杨德慧	父母
梁朝伟	张曼玉	情侣
理雅各	乔治	兄弟姐妹
戴安娜王妃	威廉王子	父母
约翰·列侬	Lennon	父母
曹斯杰	郭台铭	父母
杨进明	侯耀文	师生
刘少奇	王光美	夫妻
秦子涵	秦海璐	兄弟姐妹
薛世恒	薛嘉麟	兄弟姐妹
孙穗芳	孙中山	祖孙
贾政	王夫人	夫妻
李自成	韩金儿	夫妻
焦菊隐	焦佑瀛	祖孙
袁秋年	袁慧中	父母
荣毅仁	杨鉴清	夫妻
薛涛	薛郧	父母
黄宗英	黄宗淮	兄弟姐妹
蒋经国	蒋方良	夫妻
沈湘	李晋玮	师生
何秉舜	何韵诗	兄弟姐妹
郭晓玲	郭台铭	父母
杨虎城	杨拯陆	父母
程玉菁	王瑶卿	师生
裘丽琳	周信芳	夫妻
刘姥姥	王狗儿	父母
张作霖	于凤至	父母
罗福苌	罗福成	兄弟姐妹
熊天荆	伍云甫	夫妻
陈格	陈道明	父母
刘弗陵	上官小妹	夫妻
长孙晟	长孙皇后	父母
冯巩	姜昆	同门
霍启山	霍启刚	兄弟姐妹
贺龙	贺捷生	父母
罗荣桓	颜月娥	夫妻
曹雪芹	曹玺	祖孙
邵华	毛泽东	父母
骆耀	叶问	师生
戚雅仙	金静	师生
丁至云	梅兰芳	师生
周希汉	周鄂	父母
李圣根	晏紫	夫妻
蒋兴权	张庆鹏	师生
杨载福	石达开	上下级
姚鼐	管同	师生
元顺帝	奇完者忽都	夫妻
郑中基	蔡卓妍	夫妻
陈小鲁	粟惠宁	夫妻
竹下登	竹下亘	兄弟姐妹
高盛麟	盖叫天	合作
汪圆圆	汪诗诗	兄弟姐妹
韩鹏	甄珍	夫妻
茹元俊	茹富兰	父母
邓肇坚	邓伯勤	父母
宗天意	李赛凤	父母
王世襄	王世容	兄弟姐妹
麦当娜	Rocco	父母
史兰芽	巍子	情侣
马世媛	马景涛	父母
张美娟	齐淑芳	师生
白驹荣	薛觉先	合作
唐廷枢	郑观应	合作
汉武帝	卫子夫	夫妻
傅泾波	傅履仁	父母
杰克逊	珍妮·巴斯	情侣
田起山	田士杰	父母
云燕铭	马彦祥	夫妻
司马德宗	司马德文	兄弟姐妹
亚亚·图雷	科洛·图雷	兄弟姐妹
夏侯楙	夏侯子江	兄弟姐妹
何鸿燊	何超凤	父母
唐诗咏	黄嘉乐	情侣
杨小萍	杨庆煌	兄弟姐妹
袁日初	袁祥仁	兄弟姐妹
江竹筠烈士	彭咏梧	夫妻
许志安	郑秀文	情侣
陶希圣	何炳松	同门
曾志伟	曾国犹	父母
施文心	葛存壮	夫妻
周希汉	璇	夫妻
三毛	缪进兰	父母
崔兰田	周海水	师生
北野武	久石让	合作
李寿增	焦德海	师生
林月如	林天南	父母
许冠文	许冠英	兄弟姐妹
郑进一	郑伦境	父母
曹彰	曹丕	兄弟姐妹
荣德生	荣毅仁	父母
冯培澜	朱光祥	兄弟姐妹
王心凌	徐美珠	父母
穆桂英	佘太君	祖孙
杨鸣	张庆鹏	合作
海德里希	希姆莱	合作
卢汉	卢浚泉	父母
陈赓	陈知建	父母
傅腾龙	傅琰东	父母
马鹤凌	马冰如	父母
孙科	蓝妮	夫妻
蒋介石	王采玉	父母
赵晨浩	赵本山	师生
马寅初	马仰班	父母
苗彤	苗俊	兄弟姐妹
张无忌	张翠山	父母
苏茹	万剑一	同门
任剑辉	谭倩红	师生
张兰秦	尚长荣	师生
龙剑笙	任剑辉	师生
蔡和森	向警予	夫妻
卓文君	司马相如	夫妻
朱挺	权磊	合作
武宫正树	梶和为	父母
福原爱	锦织圭	情侣
马拉多纳	贝罗妮卡	情侣
梅尔·吉布森	奥克萨娜·格里高利耶娃	情侣
吕后	吕泽	兄弟姐妹
白登云	王瑞芝	好友
杨洪基	杨瓯	父母
里根	Reagan	祖孙
孔祥熙	孔令仪	父母
夏明翰	夏明衡	兄弟姐妹
倪萍	王文澜	夫妻
吉新鹏	何晓燕	夫妻
武田胜赖	诹访赖重	祖孙
董必武	陈碧英	夫妻
梁从诫	梁启超	祖孙
黄任中	小潘潘	父母
余嘉锡	余逊	兄弟姐妹
赵晨浩	张学友	同门
罗鹰石	杜莉君	夫妻
黄忠	刘备	上下级
郭广昌	梁信军	合作
胡也频	丁玲	夫妻
曹茂	曹操	父母
张家杰	曹敏莉	夫妻
蒋纬国	蒋经国	兄弟姐妹
王濛	刘秋宏	合作
赖俊健	赖明明	兄弟姐妹
释永信	释小龙	师生
小S	蔡康永	合作
霍慧芬	崔世安	夫妻
周绚文	菲利浦·林	夫妻
毛泽东	毛岸青	父母
立花道雪	由布惟常	祖孙
张咏梅	方亚芬	同门
邵逸夫	黄美珍	夫妻
丁敏君	周芷若	同门
林毅夫	陈云英	夫妻
杨云	潘长江	夫妻
韩金凯	濮存昕	父母
常俊丽	桑振君	师生
韩明淑	朴成俊	夫妻
林毅夫	林旺松	兄弟姐妹
弗朗西斯	姚明	好友
王晓临	李多奎	师生
陈阿娇	陈午	父母
霍震霆	霍震宇	兄弟姐妹
邓继增	陈鸣志	同门
朱小华	任佩珍	夫妻
李学清	李洲	兄弟姐妹
范伟	高秀敏	合作
刘翔	尹靖	合作
蒋友青	张立方	兄弟姐妹
廖一梅	孟京辉	夫妻
陈嘉桓	杜宇航	同门
裘盛戎	裘红	父母
张成泽	金正日	亲戚
傅作仁	董振凡	夫妻
陈立夫	陈其业	父母
韦唯	迈克尔·史密斯	夫妻
李秀成	洪秀全	上下级
张丰毅	霍凡	夫妻
徐世昌	徐世璋	兄弟姐妹
梁左	梁天	兄弟姐妹
迪甘	鲍斯高·伊泽森·柏莱拉·莱特	父母
勘九郎	我爱罗	兄弟姐妹
黄君璧	黄仰荀	父母
辛吉斯	蒂鲍特·胡丁	夫妻
何甘棠	何东	兄弟姐妹
贾赦	王熙凤	父母
宋奕萱	刘秀荣	师生
白崇禧	马佩璋	夫妻
邵美琪	郑伊健	夫妻
景荣庆	范宝亭	师生
林瑞阳	曾哲贞	夫妻
雷英	李近秋	师生
沈寿林	强月泉	师生
陈见飞	陈冠希	兄弟姐妹
陈坚红	王志文	夫妻
邢嘉倩	林青霞	父母
贾赦	贾迎春	父母
王烁	周迅	情侣
荀慧生	荀皓	祖孙
盖叫天	张善鸿	祖孙
李慧来	王群英	师生
郭英丽	苗文华	同门
许世勋	许士芬	兄弟姐妹
罗文	郑伊健	师生
钱阿四	姚宝香	师生
木谷实	铃木为次郎	师生
郑家纯	郑裕彤	父母
张继科	刘诗雯	情侣
李慧来	王应立	师生
耶律齐	郭破虏	亲戚
赵佩茹	赵希贤	父母
森园美咲	板野友美	好友
任剑辉	谭兰卿	合作
孙玥	何宁宁	父母
林挺生	林传凯	祖孙
路飞	布鲁克	合作
杨雪霏	陈长玲	师生
成吉思汗	察合台	父母
俞大维	俞大彩	兄弟姐妹
赵晨浩	曾志伟	好友
傅作义	傅璞	亲戚
孝庄文皇后	皇太极	夫妻
孟庆南	王丽丽	夫妻
安雅	孔众	夫妻
赵薇	汪雨	情侣
是元介	元卫觉醒	合作
叶宜津	赵哲宏	夫妻
宋德珠	阎岚秋	师生
陈半丁	吴昌硕	师生
张桂凤	王金萍	师生
毛东东	毛新宇	父母
吴小莉	周秉均	夫妻
朱玉峰	董洪松	师生
邢李源	林青霞	夫妻
潘玉良	刘海粟	师生
朱媛媛	辛柏青	夫妻
阿奴	圣姑	师生
钱学森	钱永刚	父母
卫长公主	栾大	夫妻
刘德海	吴祖强	合作
曹操	曹据	父母
观世音	阿弥陀佛	师生
刘威	滕文骥	合作
丰臣秀吉	丰臣秀次	亲戚
张悬	焦元溥	兄弟姐妹
蒋孝严	蒋经国	父母
庹宗康	李婉钰	情侣
李文云	胡学礼	夫妻
林妙可	陆子艺	好友
贾永婕	王兆杰	夫妻
魏文亮	张文斌	师生
余三胜	余紫云	父母
聂远	杨光	夫妻
杨蕊	林志颖	好友
袁日初	袁龙驹	兄弟姐妹
王琴侬	陈德霖	师生
陈昌浩	陈祖莫	父母
唐泽寿明	山口智子	夫妻
陶菲克	穆利奥·汉多约	师生
吴晗	吴春曦	兄弟姐妹
孙悦	古晨	情侣
余秋里	刘素阁	夫妻
松田圣子	神田正辉	夫妻
李渊	李元吉	父母
太乙真人	元始天尊	师生
周永恒	周启生	亲戚
方楚雄	关山月	师生
孝景皇后	臧儿	父母
鲁冠球	鲁伟鼎	父母
尹明善	尹喜地	父母
群福庆	刘荣云	师生
赵树海	戴一瑜	夫妻
王义夫	王辉	父母
瞿秋白	耿济之	好友
李沛文	林孔湘	好友
胡志军	徐根宝	师生
詹姆斯·默多克	基思·默多克	祖孙
孙治强	林伦可	夫妻
白歆惠	陈乔恩	好友
莫声谷	张三丰	师生
山下敬吾	菊池康郎	师生
舒桐	舒茂林	父母
景荣庆	宋富亭	师生
汤子嘉	汤珈铖	兄弟姐妹
李晓霞	郭跃	合作
高笑林	马三立	师生
潘汉年	潘莘臣	父母
洪金宝	钱似莺	祖孙
方东树	姚鼐	师生
曾昭娟	宋海燕	同门
元太祖	窝阔台	父母
孟京辉	廖一梅	夫妻
何超云	陈婉珍	父母
杜丽	王义夫	师生
霍震寰	陈琪琪	夫妻
叶玉卿	胡兆明	夫妻
卢惠光	成龙	上下级
张振圻	佟守本	师生
杨维	张洁雯	合作
章伯钧	李健生	夫妻
舒淇	冯德伦	情侣
薛宝钗	王熙凤	兄弟姐妹
薛永年	王树田	合作
王昭君	呼韩邪单于	夫妻
黄炎培	黄万里	父母
戴蕴慧	戴思聪	父母
刘思齐	毛泽东	父母
亦舒	倪亦方	兄弟姐妹
武修文	郭芙	同门
宋高宗	刘贤妃	夫妻
郑佩佩	原子鏸	父母
戴季陶	戴安国	父母
康康	杨巧宁	情侣
周星驰	凌宝儿	父母
王楠	李菊	合作
李赋京	韦加宁	父母
佟有为	佟剑涛	父母
闫妮	邹元清	父母
杨国强	杨子莹	父母
李娜	晏紫	合作
刘若英	刘咏尧	祖孙
周韶宁	李开复	合作
朱立伦	高育仁	父母
杨淇	张艾嘉	师生
李砚萍	李顺来	父母
贺龙	彭德怀	合作
周武王	周成王	父母
凯特·米德尔顿	Middleton	父母
高闯	新凤霞	师生
汪野亭	汪桂英	父母
戈公振	戈绍怡	兄弟姐妹
元睿宗	元宪宗	父母
张传良	邹市明	师生
贾宝玉	王夫人	父母
钱思亮	钱复	父母
张岫云	王海玲	师生
宛萍	濮方	父母
韩布新	张艳敏	师生
殷旭	章子怡	亲戚
余立金	余小敏	父母
董仲舒	公孙弘	合作
徐世昌	徐保慈	祖孙
施小墨	施今墨	父母
常东升	东起	兄弟姐妹
蔡文姬	蔡邕	父母
吴菱仙	朱幼芬	师生
希特勒	爱娃·布劳恩	夫妻
菲尔·杰克逊	珍妮·巴斯	情侣
冯坤	陈忠和	师生
麦凯恩	杰克	父母
冯钟芸	任继愈	夫妻
阿比·克兰茜	彼得·克劳奇	夫妻
陈中	张美	父母
鲜灵霞	孙桂荣	师生
威尔士亲王	哈利王子	父母
房仕胜	房仕德	兄弟姐妹
阿劳	鲁思·施耐德	夫妻
陆定一	唐义贞	夫妻
洪晃	乔冠华	父母
吴敦义	颜安汝	父母
安德鲁·约翰逊	查尔斯·约翰逊	父母
金素雯	金素琴	兄弟姐妹
古龙	郑小龙	父母
李宗盛	周华健	合作
武修文	郭靖	师生
李泽楷	李嘉诚	父母
焦裕禄	徐俊雅	夫妻
陈康	汤用彤	师生
成吉思汗	阿剌海别吉	父母
小早川秀秋	木下家定	父母
钱妙花	任伯棠	合作
侯喜瑞	杨小楼	合作
田丽	李雨泽	情侣
艾未未	路青	夫妻
秦剑	曾江	亲戚
谢东	侯耀华	兄弟姐妹
蒙奇·D·路飞	娜美	合作
邓亚萍	林志刚	夫妻
枣祗	枣嵩	祖孙
陈蝶衣	陈燮阳	父母
乔冠华	洪晃	父母
蔡加敏	马介璋	父母
袁杰英	袁阔成	亲戚
高育仁	朱立伦	父母
沙奎尔·奥尼尔	詹姆斯	合作
蒋友青	蒋方良	祖孙
胡婷婷	胡志强	父母
孙穗芬	蓝妮	父母
王洪礼	唐尧东	师生
刘国梁	陈世瑶	亲戚
鲁迅	周福清	祖孙
冯慧兰	冯来金	父母
曼德拉	马克贾托·曼德拉	父母
姜妙香	冯金芙	夫妻
黄任中	黄少谷	父母
赵元任	赵如兰	父母
戚雅仙	袁雪芬	合作
曹操	曹衮	父母
姚水娟	竺基焕	师生
戴国恒	唐福广	父母
杨得志	耿飚	合作
茅盾	孔德沚	夫妻
周淑英	周广	兄弟姐妹
C罗	劳尔	合作
谭鑫培	谭元寿	祖孙
西恩·潘	麦当娜	夫妻
李克农	钱壮飞	合作
郑芝龙	郑芝虎	兄弟姐妹
曹宪	曹节	兄弟姐妹
金孝渊	徐珠贤	合作
刘永行	刘永言	兄弟姐妹
马鸿逵	马福祥	父母
李振辉	李小龙	兄弟姐妹
陈连升	陈长鹏	父母
晏紫	李贤义	父母
阮玲玉	唐季珊	情侣
汪精卫	汪文惺	父母
李宗仁	郭德洁	夫妻
张丹露	赵文卓	夫妻
贾赦	邢夫人	夫妻
迈克尔·乔丹	伊维特·普利托	情侣
梅艳芳	成龙	好友
杜志国	杜淳	父母
张韶涵	张韶轩	兄弟姐妹
李亨	李系	父母
卡梅伦	伊恩·卡梅伦	父母
黄宗江	阮若珊	夫妻
李宝櫆	许德义	亲戚
李香君	李贞丽	父母
阎立品	徐艳琴	合作
顺治	孝庄太后	父母
吕后	鲁元公主	父母
弗洛伊德	马莎·伯莱斯	夫妻
范长江	沈钧儒	父母
洪秀全	洪天光	父母
熊倪	李京曼	夫妻
夏侯光姬	司马睿	父母
徐睿	王珞丹	情侣
上官婉儿	郑氏	父母
林彪	张浩	兄弟姐妹
德川家光	德川秀忠	父母
陆锦娟	盛燮	合作
施瓦辛格	玛丽娅·施莱弗	夫妻
任伯年	任熊	亲戚
卞兰	苗立杰	合作
迈克尔·乔丹	杰弗里·乔丹	父母
殷秀梅	潘兆英	父母
孔子	卜商	师生
加藤罗莎	玉木宏	情侣
巧姐	贾琏	父母
马元亮	马世啸	兄弟姐妹
余叔岩	谭鑫培	师生
王丽云	车晓	父母
查传讷	金庸	父母
庄泳	王敏	好友
伍兹	艾琳·诺德格林	夫妻
郑曼青	宋美龄	师生
孙祥	孙吉	兄弟姐妹
方志敏	方志纯	兄弟姐妹
格瓦拉	阿尔贝托	好友
卢兰	李永波	师生
Arissa	吴建豪	情侣
罗明珠	李丽珍	合作
班昭	班彪	父母
康万生	徐敬民	父母
胡和生	苏步青	师生
迪甘	卡卡	兄弟姐妹
蔡依林	蔡旻纹	兄弟姐妹
邓丽君	邓永佳	亲戚
顺治	孝康章皇后	夫妻
邹永山	陈连登	师生
贺子珍	李敏	父母
艾薇儿	Lavigne	兄弟姐妹
徐天红	傅全香	合作
李亚鹏	窦靖童	父母
何超仪	何鸿燊	父母
任弼时	任远远	父母
海霞	李梓萌	合作
林子萱	刘至翰	夫妻
罗伯特·霍里	阿什利·霍里	父母
姚苌	姚襄	兄弟姐妹
石静宜	石凤翔	父母
张宝全	王秋杨	夫妻
刘欢	毛阿敏	合作
林月云	侯佩岑	父母
卫青	卫媪	父母
孔祥熙	宋蔼龄	夫妻
汉章帝	汉明帝	父母
赵叔孺	沙孟海	师生
麻生太郎	铃木善幸	父母
洪秀全	冯云山	上下级
菊丸英二	大石秀一郎	好友
王美华	曾宝仪	父母
郑进一	林慧萍	合作
祝允明	祝颢	祖孙
道格拉斯·麦克阿瑟	MacArthur	祖孙
张怡宁	徐威	夫妻
顾颉刚	殷履安	夫妻
高玉秋	常香玉	师生
叶问	叶准	父母
余玠	赵葵	上下级
曹丕	曹植	兄弟姐妹
奥多姆	布朗	合作
吴承瑛	吴承瑜	兄弟姐妹
邓亚萍	乔红	合作
劳拉·布什	珍娜	父母
何鸿燊	何世光	父母
虚竹	叶二娘	父母
王北星	王长友	父母
花月仙	刘淑萍	师生
蒋纬国	邱爱伦	夫妻
康霞	马金凤	师生
林子聪	周星驰	好友
张博宇	张丰毅	父母
邓琳琳	邓杰古	父母
张亚雯	魏轶力	合作
于素秋	于占元	父母
曹徽	曹操	父母
周少麟	周信芳	父母
蔡依珊	蔡惠媚	亲戚
厉慧森	韩凤英	父母
阳友鹤	刘怀叙	合作
霍英东	霍震寰	父母
袁涣	袁霸	兄弟姐妹
彭福林	范福泰	同门
章含之	洪君彦	夫妻
赵文卓	张丹露	夫妻
王濛	马庆忠	师生
邢嘉倩	潘世亨	情侣
邓世昌	邓浩洪	父母
王应伟	王大珩	父母
李德伦	马思聪	合作
马季	侯宝林	师生
乌兰夫	云曙碧	父母
朱玲玲	霍启刚	父母
翁佳慧	岳美缇	师生
沈寿林	周钊泉	师生
金敏智	杨诚俊	好友
李宣捷	王晓凌	合作
钟丽淇	梁荣忠	情侣
诺罗敦·诺林达拉邦王子	诺罗敦·诺林达拉邦王子	父母
老狼	潘茜	夫妻
董俊峰	董少英	父母
慕容廆	慕容皝	父母
李克用	李国昌	父母
孙明珠	孙柏龄	父母
刘德凯	刘雪华	夫妻
曹操	曹林	父母
祝允明	李应祯	父母
李寿增	张寿臣	同门
彭真	张洁清	夫妻
那正鑫	傅德威	师生
刘銮雄	洪欣	情侣
高凤岭	林信斋	师生
津田左右吉	白鸟库吉	师生
张丰毅	吕丽萍	夫妻
孔子	颜无繇	师生
陈幸妤	赵翊安	父母
成龙	吴绮莉	情侣
群福庆	刘荣安	师生
汪建民	柯以柔	情侣
潘金莲	武松	父母
织田信长	织田信秀	父母
王励勤	潘晓婷	情侣
王学义	李增瑞	师生
刘桂凤	朱福喜	师生
陈金莲	毕春芳	合作
钱壮飞	徐双英	夫妻
李彩华	林峰	情侣
杜震宇	仲书渺	夫妻
刘仲容	赵守钰	父母
李蔷华	俞振飞	夫妻
王小利	李琳	夫妻
赵雅芝	黄锦燊	夫妻
吕后	吕台	亲戚
何鸿燊	何猷光	父母
长孙皇后	李渊	父母
哈希姆·塔比特	塔比特·曼迦	父母
大S	徐熙娣	兄弟姐妹
陈康	方东美	师生
陈盛泰	陈金爵	祖孙
刘肥	刘邦	父母
朱炯	贾樟柯	夫妻
代善	多尔衮	兄弟姐妹
戈薇	日暮草太	兄弟姐妹
白全福	宋勇	师生
吕大临	吕大防	兄弟姐妹
容祖儿	陈奕迅	好友
马景涛	唐韵	夫妻
基泰英	柳真	情侣
范曾	缪镜心	父母
筱桂花	孙凤鸣	师生
胡兰畦	陈毅	好友
丰子恺	夏丏尊	师生
鲍桂山	郝春年	师生
傅恒	哈什屯	亲戚
常宝堃	常宝霖	兄弟姐妹
朱珠	李泉	情侣
徐志摩	金庸	兄弟姐妹
蒋孝勇	蒋方良	父母
秦琼	尉迟恭	好友
王治郅	王非	师生
孔祥熙	孙中山	兄弟姐妹
陈豪	陈茵媺	夫妻
郭台铭	黄子容	父母
吴佩孚	吴可成	父母
贾敬	贾珍	父母
童芷苓	童寿苓	兄弟姐妹
孔瑶竹	孔燕松	兄弟姐妹
陈金	夏煊泽	合作
黄遵宪	何如漳	合作
贾宝玉	贾政	父母
曹薰铉	郑美和	夫妻
阿劳	卡洛斯·阿劳	父母
高崚	吴圣	夫妻
黄药师	陈玄风	师生
阎虹羽	叶红珠	师生
陈德容	王赞策	夫妻
欧倩怡	郭令山	父母
虢国夫人	杨玄琰	父母
福田赳夫	福田康夫	父母
谭杰希	魏丹丹	情侣
郭英丽	常俊丽	同门
傅志清	傅天正	父母
汪雨	李钰	情侣
黄百禄	陈水扁	亲戚
石评梅	石铭	父母
黄绍竑	李宗仁	上下级
赵合德	赵飞燕	兄弟姐妹
俞平伯	俞樾	祖孙
梁靖琪	梁家树	父母
赵立华	洪影	师生
毛人凤	向影心	夫妻
诸葛亮	诸葛尚	祖孙
李世民	唐高宗	父母
陈水扁	黄睿靓	父母
吴玉章	恽代英	好友
李小婉	林申	父母
刘砚芳	杨小楼	父母
太穆皇后	李渊	夫妻
蒋勤勤	李大为	情侣
孙甫亭	孙振才	父母
范长江	范长城	兄弟姐妹
薄熙永	胡明	父母
李咏	法图麦·李	父母
周德山	马三立	师生
蒋丽莎	隋菲菲	兄弟姐妹
彭寂宽	彭寿山	父母
张桂凤	范瑞娟	合作
秦志戬	吴颢	师生
夏侯尚	夏侯奉	亲戚
周武王	周文王	父母
陈水扁	赵建铭	父母
伯里克利	山提波斯	父母
张小凡	林惊羽	兄弟姐妹
梁雨润	许倩玲	夫妻
毛泽民	毛远新	父母
荀彧	荀淑	祖孙
杰夫·格林	内纳德·科斯蒂奇	合作
杜月笙	杜维藩	父母
罗格	萨马兰奇	情侣
王海川	刘亚男	夫妻
赵恒	宋太宗	父母
自来也	漩涡鸣人	师生
施光南	钟复光	父母
杨振宁	杜聿明	父母
汉武帝	汉景帝	父母
范斌	宫鲁鸣	合作
阎桂祥	谭正岩	父母
廖凤舒	陈香梅	祖孙
蔡一智	周雪芳	夫妻
姚晨	曹郁	夫妻
劳德诺	岳灵珊	同门
丁至云	王少卿	师生
李蔷华	关正明	夫妻
江淑娜	江蕙	兄弟姐妹
杨小楼	谭鑫培	父母
郭颂	郭增友	兄弟姐妹
张天爱	邢嘉倩	父母
小泉纯一郎	宫本佳代子	夫妻
方文山	吴宗宪	好友
徐熙媛	徐熙娣	兄弟姐妹
老舍	舒乙	父母
侯耀华	侯瓒	亲戚
道格拉斯·麦克阿瑟	路易丝	夫妻
赵学义	籍薇	师生
阎桂祥	谭孝曾	夫妻
武三通	武修文	父母
孙志浩	贾静雯	夫妻
服部平次	服部静华	父母
杨丞琳	元骏豪	情侣
涂少波	涂序生	父母
杨诺思	杨受成	父母
谷开来	薄瓜瓜	父母
勒布朗·詹姆斯	奥尼尔	合作
莎士比亚	约翰·莎士比亚	父母
刘彻	窦太后	祖孙
李阳	李金	夫妻
宋子安	胡其瑛	夫妻
张伯驹	潘素	夫妻
詹姆斯	霍华德	合作
丁子高	丁永方	父母
卞之琳	青林	夫妻
相小泉	刘金玉	合作
孟广美	吴大维	情侣
曹丕	曹冲	兄弟姐妹
文根英	文智英	兄弟姐妹
罗京	李瑞英	合作
孔祥熙	孔令杰	父母
项英	张亮	夫妻
萨科齐	让·萨科齐	父母
陈青远	陈丽洁	父母
孙燕姿	纳迪姆	夫妻
卞学鐄	赵如兰	夫妻
贾代善	邢夫人	父母
叶怡均	田连元	师生
焦德海	刘德智	合作
种谔	种世衡	父母
王羲之	王导	亲戚
饶漱石	陆璀	夫妻
徐阿三	徐小香	兄弟姐妹
司马懿	司马防	父母
秦汉	孙国豪	父母
孙悟空	白龙马	同门
李恪	李世民	父母
张卫健	江欣燕	情侣
周正毅	杨恭如	情侣
戴娆	张国立	好友
孙怡云	孙甫亭	父母
邓演达	黄琪翔	好友
侯世宏	林月云	情侣
马樟花	袁雪芬	合作
洪天祥	曹恩玉	父母
左塞尔	尼玛厄萨普	父母
黄百韬	柳碧云	夫妻
高兴荣	张云标	师生
山治	娜美	合作
蔡元培	林文铮	父母
洪晃	章含之	父母
广末凉子	冈泽高宏	夫妻
萧绎	萧衍	父母
李宗仁	李幼邻	父母
黄炎培	黄竞武	父母
梅贻琦	梅曾臣	父母
张恨水	周淑云	夫妻
李仕凡	孙莹莹	情侣
魏骏杰	滕丽名	情侣
李清照	李格非	父母
邓朴方	卓琳	父母
柯棣华	柯印华	父母
梅竹芬	梅巧玲	父母
赵连喜	崔玉柱	师生
孙穗芳	孙治平	兄弟姐妹
林姮怡	林欣荣	父母
张博	兽兽	情侣
王澄清	吴赤芳	夫妻
杨振宁	杜致礼	夫妻
金筱邦	金月升	兄弟姐妹
刘禅	刘璿	父母
荣剑尘	明永顺	师生
蔡尚思	柳诒征	师生
李蓉芳	李荣安	合作
刘海粟	傅雷	好友
李家诚	李兆基	父母
张乐怡	宋子文	夫妻
陶菲克	佐戈·苏普里扬托	师生
金开芳	熊氏	父母
郑渊洁	郑洪升	父母
佐勒菲卡尔·阿里·布托	贝娜齐尔·布托	父母
刘桂娟	李世济	师生
李元霸	李世民	兄弟姐妹
李倩	范志毅	夫妻
威廉·莎士比亚	约翰·莎士比亚	父母
戴辛尉	戴思聪	父母
干露露	雷炳侠	父母
宇多田光	藤圭子	父母
窦靖童	窦家媛	兄弟姐妹
赛义夫·伊斯拉姆·卡扎菲	卡扎菲	父母
孔东梅	李敏	父母
毛岸英	毛泽东	父母
庄静固伦公主	庄敬和硕公主	兄弟姐妹
胡雪岩	阳琪	夫妻
孙莹莹	何念慈	父母
任法融	王嗣林	师生
江钰源	欧凤珍	父母
赵贞玉	桑振君	师生
阴丽华	汉光武	夫妻
王明	王芳妮	父母
孝庄	皇太极	夫妻
王尔晴	敬一丹	父母
牛淑贤	赵兵伟	师生
蒋友柏	林欣荣	父母
林则徐	沈葆桢	父母
武敦儒	郭芙	同门
谭嗣同	刘光第	合作
胡耀邦	李昭	夫妻
刘雪涛	张君秋	合作
刘思齐	毛岸青	亲戚
徐子珊	游乃海	情侣
付洋	傅锐	兄弟姐妹
王文娟	徐玉兰	合作
罗嘉良	方敏仪	夫妻
薄瓜瓜	谷开来	父母
武魁海	魏文亮	师生
黎洪模	黎群	父母
白全福	白宝山	父母
叶在馥	刘峻峰	合作
吴鉴泉	马岳梁	父母
孙甫亭	孙振泉	父母
马连登	马增蕙	父母
沮渠蒙逊	沮渠男成	兄弟姐妹
马潮水	费翠棠	师生
李亨	李侹	父母
陈玉莲	周润发	好友
谭正岩	阎桂祥	父母
庹宗康	王菲雅	夫妻
晋成帝	司马岳	兄弟姐妹
韩信	刘邦	上下级
李薇华	荀慧生	父母
杜义德	尤太忠	上下级
赵津生	范振钰	师生
王娡	田蚡	兄弟姐妹
芦璐	刘国正	夫妻
韩素音	周惠音	父母
安倍晋三	岸信介	祖孙
郭士强	郭凯伦	亲戚
王玉蓉	胡铁耕	同门
崔光丽	魏明伦	合作
耿伯春	赵津生	合作
董浩	董静山	父母
莫声谷	俞莲舟	同门
李嘉诚	周凯旋	情侣
洪虎	洪学智	父母
崔真实	崔真英	兄弟姐妹
文徵明	唐寅	好友
张遵	张苞	父母
孙治强	孙中山	祖孙
林则徐	郑淑卿	夫妻
孙盛武	寇春华	师生
戈公振	戈铭烈	父母
唐禾香	谢锐青	师生
陈毅	陈小鲁	父母
邓世昌	邓秀蝉	父母
苏茹	田灵儿	父母
于俊波	张寿臣	同门
韩慎先	王琴生	师生
梁洛施	李泽楷	夫妻
于芬	郭晶晶	师生
王谦祥	李增瑞	合作
蒋友柏	蒋经国	祖孙
仓持明日香	仓持明	父母
郑咏恩	郑安仪	兄弟姐妹
许绍雄	许广平	亲戚
王仪涵	谢杏芳	合作
李玲玉	杰西	父母
李来	罗微	夫妻
谢晋	徐大雯	夫妻
陈发科	陈小旺	祖孙
张爱玲	周瘦鹃	好友
罗福苌	罗福颐	兄弟姐妹
蔡文姬	司马师	父母
李双江	李天一	父母
徐悲鸿	孙多慈	情侣
刘诗雯	常晨晨	合作
汤飞凡	何琏	夫妻
曹其敏	陈美英	合作
王希怡	刘谦	情侣
小泉孝太郎	小泉进次郎	兄弟姐妹
时钧	汪家鼎	师生
蒋百里	徐志摩	亲戚
车侑蓝	车宝蓝	兄弟姐妹
唐奕	潘佳章	师生
梁璧	叶问	师生
张栩	张心澄	父母
马载尧	马晓天	父母
宋久林	宋久林	合作
吴菱仙	王蕙芳	师生
柯棣华	郭庆兰	夫妻
科比	埃迪·琼斯	合作
徐天红	高剑琳	合作
王昆仑	何香凝	合作
高岗	李力群	夫妻
叶正	叶准	兄弟姐妹
武松	周侗	师生
连胜武	路永佳	夫妻
解忧公主	弟史	父母
常宝霆	常宝丰	兄弟姐妹
唐高祖	窦皇后	夫妻
尚慧敏	吴素秋	师生
陈美华	陈冠希	兄弟姐妹
曹达华	安德尊	父母
李赋京	梁之彦	合作
杨威	李小鹏	合作
伯颜	晓古台	父母
周恩来	邓颖超	夫妻
金贤珠	苏志燮	情侣
袁小田	袁和平	父母
袁惟仁	莫凡	合作
李文云	李凤翔	父母
姚席珍	杨德云	兄弟姐妹
竺水招	竺小招	父母
陈宝珠	杨天经	父母
克里斯特尔斯	里奥	父母
贾母	贾代善	夫妻
曾江	曾慕雪	父母
何超云	何超莲	兄弟姐妹
张浚	张咸	父母
翁美玲	郑少秋	合作
叶盛兰	叶莉珠	父母
梁锦松	梁司渝	父母
乐基儿	黎明	夫妻
小香玉	常香玉	祖孙
姜一郎	周韵	父母
光武帝	汉明帝	父母
何鸿燊	何超云	父母
李泽楷	李长治	父母
吉诺比利	邓肯	合作
新凤霞	戴月琴	师生
雷英	何顺信	师生
毛甜懿	毛泽东	祖孙
丁聪	丁悚	父母
曹髦	曹丕	祖孙
托勒密二世	阿西诺亚二世	夫妻
许慧欣	许嘉凌	兄弟姐妹
姜大卫	李琳琳	夫妻
鲁迅	朱安	夫妻
赵本山	于月仙	兄弟姐妹
迟浩田	迟星北	父母
鲍金龙	袁雪芬	师生
李望知	薄熙来	父母
胡军	卢芳	夫妻
张学友	张瑶萱	父母
金妍儿	布莱恩·奥泽	师生
毛兰花	朱振家	夫妻
段奕宏	王瑾	夫妻
黄现璠	黄门十八贤	师生
杨淑君	刘聪达	师生
孙科	孙治强	父母
冯异	曹诩	合作
朱永棠	张柏芝	情侣
鞠萍	蒋翼遥	父母
李渊	窦皇后	夫妻
薄熙来	薄一波	父母
关楚耀	关维麟	父母
陆喜才	陆凤琴	兄弟姐妹
林申	李小婉	父母
切·格瓦拉	阿尔贝托	好友
汪雨	蒋欣	情侣
冯跋	冯爱居	父母
赵剑英	覃辉	夫妻
穆托姆博	约翰·汤普森	好友
谢杏芳	张洁雯	合作
谢天竞	谢亚龙	父母
蔡龙云	蔡桂勤	父母
齐春雷	方亚芬	合作
杨扬	王春露	合作
胡碧兰	胡素仙	师生
傅彦	付洋	兄弟姐妹
宫粉红	罗乐林	父母
宋美龄	宋庆龄	兄弟姐妹
吴承恩	吴锐	父母
谭孝曾	谭正岩	父母
李凌枫	张君秋	师生
关礼杰	关枫盈	父母
沈坚强	庄泳	夫妻
皮定均	皮国宏	父母
李飞龙	姜世续	师生
张謇	蔡元培	好友
朴正熙	陆英修	夫妻
吴璘	楼诏	上下级
郝兰田	谢宝云	师生
秦志戬	许昕	师生
周瑜	周循	父母
胡宗南	胡为真	父母
林挺生	林蔚东	父母
傅希如	赵群	夫妻
马修·弗洛伊德	伊丽莎白·默多克	夫妻
潘迎紫	陈鸿烈	夫妻
孙毓敏	李素萍	师生
王个簃	王一亭	好友
安胜浩	a	兄弟姐妹
冯思语	冯小刚	父母
任剑辉	文良玉	师生
包庭政	包小松	亲戚
任弼时	陈琮英	夫妻
金恩圣	至上励合	合作
上官婉儿	唐中宗	夫妻
小S	汪小菲	兄弟姐妹
马三立	阎笑儒	师生
侯军	侯耀文	亲戚
张蓉芳	胡进	夫妻
王荣山	王永成	父母
严慰冰	陆健健	父母
钱学森	钱镠	亲戚
高宝贤	谭富英	师生
谭凤元	石连城	师生
司马懿	曹真	合作
侯瓒	侯耀文	父母
薛嘉麟	薛世恒	兄弟姐妹
韩布新	杨秀木	师生
李劫夫	张洛	夫妻
黄睿靓	吴淑珍	父母
猪哥亮	邢峰	合作
九鬼嘉隆	九鬼定隆	父母
江新蓉	滕雪楼	师生
刘诗涵	王若伊	好友
于文凤	于树权	兄弟姐妹
启功	陈垣	师生
王珞丹	黄晓明	同门
秦岚	陆川	情侣
威廉·安德斯	詹姆斯·洛弗尔	合作
周总理	万冬儿	父母
朱时茂	范旭霞	夫妻
何爱榆	何东	亲戚
王觉侠	王培林	父母
宝咏琴	刘鸣炜	父母
萧淑芳	吴作人	夫妻
于月仙	赵本山	兄弟姐妹
苗侨伟	姚凤丝	情侣
杜淳	张嘉倪	情侣
汉景帝	汉武帝	父母
伊瓜因	费德里科·伊瓜因	兄弟姐妹
王义夫	刘国珍	父母
林徽因	梁思成	夫妻
全公主	孙霸	兄弟姐妹
陈独秀	高大众	夫妻
冯子洋	郭贵臣	师生
陈香梅	廖凤舒	祖孙
于凤至	张闾瑛	父母
潘长江	杨云	夫妻
马秋仙	王银柱	合作
刘春红	马文辉	师生
钟丽缇	严铮	夫妻
何珈好	保剑锋	夫妻
刘弗陵	汉武帝	父母
花淑兰	曾昭娟	师生
杜丽	齐登云	祖孙
刘半农	商鸿逵	师生
熊明霞	覃钦祥	父母
王娡	汉武帝	父母
佐尔格	阿道夫·佐尔格	父母
尤里·马连琴科	叶卡捷琳娜·德米特里耶娃	夫妻
张杰尧	高闻元	师生
林百欣	林明珠	父母
施特劳斯	约翰·施特劳斯	父母
霍启刚	郭晶晶	夫妻
邵逸夫	方逸华	夫妻
徐申如	汤寿潜	合作
陈燕琳	李保田	父母
左芬	左思	兄弟姐妹
袁子钦	黄永秀	夫妻
拉莫斯	Rene	兄弟姐妹
叶天士	叶万青	祖孙
韩宰锡	朴率美	夫妻
金正男	金敬姬	亲戚
小泉纯一郎	小泉孝太郎	父母
奇米·雷克南	珍妮·达尔曼	夫妻
吴淑珍	黄睿靓	父母
阎维文	刘卫星	夫妻
谈镐生	邓团子	夫妻
周信芳	周英华	父母
郭品超	许慧欣	情侣
范曾	范子愚	父母
杨盛春	韩文亭	父母
拉简·朗多	安波尔·朗多	父母
宋蔼龄	孔祥熙	夫妻
江姐	彭咏梧	夫妻
沈嘉伟	沈健伟	兄弟姐妹
哪吒	金吒	兄弟姐妹
陆建章	宋哲元	亲戚
白凯南	贾玲	合作
崔兰田	毛兰花	同门
菅直人	菅伸子	夫妻
吴三桂	吴襄	父母
马增蕙	马连登	父母
埃丝特·克利夫兰·博赞科特	格罗弗·克利夫兰	父母
郭广昌	吴加清	师生
丰子恺	丰陈宝	父母
赵家璧	鲁迅	好友
麦当娜	盖·瑞奇	夫妻
刘国栋	刘国梁	兄弟姐妹
袁甲三	袁世凯	祖孙
汉高祖	吕雉	夫妻
李飞龙	路凌云	师生
江口洋介	森高千里	夫妻
张岫云	刘海燕	师生
张国荣	麦嘉轩	亲戚
裘盛戎	方荣翔	师生
高明博	李长春	师生
蒋方良	蒋孝勇	父母
吕丽君	刘銮雄	情侣
王义夫	王威暘	父母
赵高	扶苏	上下级
钱穆	张一贯	夫妻
王明明	吴作人	师生
范瑞娟	章瑞虹	师生
杨闇公	赵宗楷	夫妻
郑东汉	蔡就胜	亲戚
胡林翼	陶静娟	夫妻
竺水招	商芳臣	合作
成钧	宋恩光	合作
哀帝	唐昭宗	父母
上官小妹	霍光	祖孙
吕瑞英	吴素英	师生
大枝雄介	大渊盛人	师生
孙毓敏	孙毓皓	兄弟姐妹
吕志武	徐国义	师生
张雨绮	周星驰	上下级
郭晓玲	曹斯杰	夫妻
陈寅恪	陈散原	父母
郑进一	胡瓜	合作
曹宪	安阳公主	兄弟姐妹
宋耀如	孙中山	父母
谭政	陈赓	兄弟姐妹
孙新	顾大嫂	夫妻
芮乃伟	吴清源	师生
冯小刚	张娣	夫妻
马鹤凌	马英九	父母
汪明荃	罗家英	夫妻
刘国正	芦璐	夫妻
侯耀文	谢东	兄弟姐妹
蒋友青	蒋孝勇	父母
李禾禾	阎维文	父母
约翰·丘吉尔	温斯顿·丘吉尔爵士	父母
谭志道	谭鑫培	父母
黄小茂	李静	夫妻
孝贤纯皇后	李荣保	父母
张小凡	田灵儿	同门
武松	潘金莲	兄弟姐妹
张韶涵	张柏御	兄弟姐妹
郝艳芳	郝英吉	父母
张国焘	杨子烈	夫妻
宛萍	濮存昕	夫妻
费英东	扈尔汉	合作
刘彦池	王励勤	情侣
常俊丽	刘伯玲	同门
林子萱	谷德昭	情侣
余音	焦守云	父母
李宝春	李少春	父母
李司棋	叶子青	父母
舒昌玉	梅兰芳	师生
吴阶平	吴安然	兄弟姐妹
顾传玠	顾传琳	兄弟姐妹
黄光裕	杜鹃	夫妻
陈云凤	夏明衡	父母
黄昆	杨振宁	同门
程训宣	徐向前	夫妻
阿剌海别吉	成吉思汗	父母
张飞	刘备	兄弟姐妹
侯耀文	刘彦	夫妻
黎洪模	蔡磊萍	父母
曹斯杰	孙美华	祖孙
周海婴	马新云	夫妻
王义夫	李天波	师生
田忠	田昌黎	父母
曾华倩	梁朝伟	情侣
包玉刚	包兆龙	父母
魏梅照	陆锦花	合作
李嘉诚	梁洛施	父母
陈婉珍	何猷启	父母
方振武	方心浩	父母
秦牧	吴紫风	夫妻
恩佐·齐达内	齐内丹·齐达内	父母
张庆鹏	易建联	合作
长孙皇后	李治	父母
关肃霜	林燕	师生
松隆子	佐桥佳幸	夫妻
顺子	黄爱莲	父母
李鸣岩	李多奎	师生
陈晓炜	于涛	夫妻
木谷实	武宫正树	师生
碧昂斯	Rowland	兄弟姐妹
李远哲	吴锦丽	夫妻
张曼玉	尔冬升	情侣
唐太宗	房玄龄	上下级
罗启仁	宗天意	父母
袁世海	尚小云	合作
瞿秋白	瞿世琥	亲戚
玛丽一世	腓力二世	夫妻
田桂凤	筱翠花	师生
谭嗣同	林旭	合作
薛姨妈	薛宝钗	父母
赵佩茹	常宝堃	合作
高博文	李途纯	亲戚
王馨平	曾江	亲戚
王晓临	李金泉	师生
何静	朱笑东	夫妻
卧云居士	龚云甫	师生
钱壮飞	钱椒	父母
张翠山	宋远桥	同门
陈盛泰	陈富涛	兄弟姐妹
张立媛	陈琪	师生
全公主	朱据	兄弟姐妹
谭世秀	谭娜	祖孙
施今墨	施如瑜	父母
周建人	王蕴如	夫妻
孔融	孔褒	兄弟姐妹
广末凉子	广末忠彦	父母
赵本山	赵一涵	父母
许晋亨	许世勋	父母
桓温	桓彝	父母
陈琦	丁赛君	合作
霍震宇	吕燕妮	父母
郭麒麟	胡中惠	父母
戈培尔	玛格塔·克邦特	夫妻
方东树	刘开	同门
真雩	天成子	同门
袁雪芬	吕瑞英	师生
吴菱仙	时小福	师生
秦叔宝	李渊	上下级
李宗盛	张震岳	合作
张澍	许亚军	夫妻
徐子淇	李晞彤	父母
齐秦	王祖贤	情侣
郑怀贤	贺顺定	师生
蔡畅	葛健豪	父母
邓丽君	成龙	情侣
叶璇	林峰	好友
方招	陈及时	同门
牛得草	王艺红艺名牛小草	师生
张二鹏	盖叫天	父母
沈殿霞	郑少秋	夫妻
傅汉思	张充和	夫妻
曹彭龄	卢章谊	夫妻
杨影	邓亚萍	合作
周汤豪	周禹侯	父母
萨科奇	布吕尼	夫妻
谭咏麟	李克勤	好友
元奎	于占元	师生
冯允庄	徐天红	合作
叶挺	叶华明	父母
陈修良	陈馥	父母
何超云	何超仪	兄弟姐妹
姜昆	李静民	夫妻
黄家驹	叶世荣	好友
吴璘	郭浩	合作
佟大为	朱雨辰	好友
萧雅	金静	合作
孔子	子贡	师生
冯宝华	高笑林	合作
三毛	张乐平	好友
宋任穷	宋彬彬	父母
武田胜赖	武田信玄	父母
田中真纪子	田中角荣	父母
洪君彦	章含之	夫妻
霍启山	霍英东	祖孙
孙兴	林美贞	夫妻
林文慧	梁汉文	夫妻
水均益	水天明	父母
姚莹莹	张锦程	情侣
尚小云	尚长荣	父母
梁宗岱	沉樱	夫妻
林楚麒	黄家驹	情侣
许德珩	劳君展	夫妻
肖桂云	李前宽	夫妻
金荷娜	权相宇	情侣
谢芮芝	荣剑尘	好友
田亮	叶一茜	夫妻
皮定均	张烽	夫妻
周作人	钱玄同	好友
景荣庆	孙盛文	师生
杨化然	管新成	同门
关羽	关樾	祖孙
袁田	袁阔成	父母
锡子刚	王瑞芝	师生
常香玉	陈玉鼎	师生
向华强	丁佩	夫妻
全公主	孙权	父母
梁皓嘉	梁锦松	父母
李充	李矩	父母
何守正	张惠妹	情侣
花淑兰	郑桂芳	师生
叶世长	张连福	师生
贾洪林	谭鑫培	师生
茅善玉	孙徐春	合作
冯异	邓禹	合作
郭台铭	郭守善	父母
侯耀华	侯耀文	兄弟姐妹
陆一婵	王文芳	夫妻
姬晨牧	姬麒麟	父母
张丽华	陈叔宝	夫妻
杨玉环	唐玄宗	夫妻
关肃霜	王韵武	师生
奎胜城	高胜泉	同门
邓文迪	鲁伯特·默多克	夫妻
曾山	曾海生	父母
水均益	王君	夫妻
林建岳	林恬儿	父母
王世襄	王世富	兄弟姐妹
朱德	康克清	夫妻
江珊	高亦心	父母
徐立清	徐延旗	父母
孙英杰	汪成荣	夫妻
易心莹	魏松遐	师生
毛新宇	刘滨	夫妻
王婉霏	刘畊宏	夫妻
容闳	容星桥	兄弟姐妹
王菲	夏桂影	父母
神田英	安藤武夫	师生
Einstein	Martin	祖孙
金亨七	金均燮	亲戚
胡志军	周穗安	师生
虎美玲	马红艳	师生
李宗瑞	梁婖婷	父母
奥兰多·布鲁姆	米兰达·可儿	夫妻
谭震林	葛慧敏	夫妻
大卫·贝克汉姆	克鲁兹·贝克汉姆	父母
李豫	李逾	父母
陆锦娟	何笑笑	合作
谭小培	谭鑫培	父母
张闾蘅	张学森	父母
岸边成雄	岸边成一	父母
高峰	那英	情侣
洪秀全	洪仁达	兄弟姐妹
杨之华	瞿独伊	父母
刘忻	王栎鑫	情侣
新艳秋	梅兰芳	师生
蔡依林	罗志祥	情侣
筱田升	岩井俊二	合作
田震	田溪	兄弟姐妹
孔子	颛孙师	师生
汪圆圆	甄子丹	兄弟姐妹
梁烈唯	Tina	情侣
作家张爱玲	赖雅	夫妻
许钟豪	许承会	父母
何政军	范雨	夫妻
龚云甫	杨小楼	合作
陈鲁豫	朱雷	夫妻
李鸿章	李鹤章	兄弟姐妹
许平君	刘奭	父母
董良翚	董必武	父母
钱嘉乐	钱小豪	兄弟姐妹
刘启	汉文帝	父母
方瑀	方声恒	父母
刘宝全	白凤鸣	师生
朱双喜	陈芷衫	师生
黎洪模	黎炜毅	祖孙
朱德群	吴冠中	好友
陈硕真	章叔胤	兄弟姐妹
舒乙	老舍	父母
姜昆	李文华	合作
程颐	程颢	兄弟姐妹
曹操	曹熊	父母
朱盛富	朱湘泉	父母
岳飞	姚氏	父母
罗纳尔多	拉伊卡·奥利维	情侣
黄袍怪	百花羞	夫妻
曹宝禄	尚福春	师生
阿娇	Twins	合作
徐帆	冯思语	父母
沈承宽	张天翼	夫妻
庄岳颖	庄佳容	兄弟姐妹
蔡慧敏	黄玉郎	情侣
陈富涛	陈富瑞	兄弟姐妹
李大双	李小双	兄弟姐妹
陈东升	孔东梅	夫妻
阚泽良	刘增祥	师生
金正恩	金正哲	兄弟姐妹
张琼姿	张琼瑶	兄弟姐妹
梁思庄	梁启超	父母
郭京飞	陆毅	兄弟姐妹
王筱翠	王侠	祖孙
蔡明	郭达	合作
陆启铿	张木兰	夫妻
侯喜瑞	关鸿宾	师生
威廉王子	凯特·米德尔顿	夫妻
吴慈美	林繁男	夫妻
罗家宝	陈锦棠	师生
戴福铸	戴国恒	父母
吕志武	陈祚	合作
弗拉基米尔·普京	柳德米拉	夫妻
高圆圆	张亚东	情侣
张晋	张楚儿	父母
戴永革	张兴梅	夫妻
陈幸妤	陈致中	兄弟姐妹
陈云凤	夏绍范	夫妻
曹云金	刘云天	合作
冯洪达	余华心	夫妻
蔡锷	小凤仙	情侣
张庆林	徐展	合作
黄睿靓	陈致中	夫妻
常宝堃	常宝霆	兄弟姐妹
王昭君	伊督智牙师	父母
曹彰	曹操	父母
赵晨浩	余文乐	好友
杨尚昆	杨白冰	兄弟姐妹
孙策	孙尚香	兄弟姐妹
俞大维	蒋经国	亲戚
岳美缇	俞振飞	师生
张琳芃	徐根宝	师生
成惠琳	成蕙兰	兄弟姐妹
张德福	徐培城	师生
李显龙	李光耀	父母
喻传海	潘笑笑	师生
吉诺比利	波波维奇	师生
金乡公主	曹宇	兄弟姐妹
司马繇	司马澹	兄弟姐妹
吴江秋	荀慧生	师生
孙穗芬	孙忠仁	父母
周璇	周民	父母
班彪	班昭	父母
洪晃	洪君彦	父母
杨化然	陈鹏	同门
庾澄庆	伊能静	夫妻
刘青云	郭蔼明	夫妻
江石溪	范氏	夫妻
叶步青	李小龙	同门
傅淦	傅斯年	祖孙
张钰	宋祖德	上下级
蔡依林	林传凯	兄弟姐妹
郭令山	欧倩怡	父母
蒋才如	李鹤飞	合作
林超群	孔雀屏	师生
群福庆	张荣玖	师生
薛姨妈	王夫人	兄弟姐妹
伊利丹	法斯琪	上下级
赵高	阎乐	父母
唐韵笙	石秀川	祖孙
李思阳	敖幼祥	师生
陈德容	琼瑶	师生
蔡英莲	张君秋	师生
郭晶晶	钟少珍	师生
艾青	高瑛	夫妻
周扬	苏灵扬	夫妻
毛泽东	贺子珍	夫妻
贺晓明	贺龙	父母
刘若英	陈升	师生
萧绰	萧思温	父母
李涛	叶剑英	合作
张爱玲	张志沂	父母
蔡锷	蔡端	父母
皇太极	豪格	父母
陈英杰	任贤齐	好友
张艾嘉	刘幼林	夫妻
吴征	杨澜	夫妻
小乔	周瑜	夫妻
贾君	贾海平	父母
李飞龙	何非凡	师生
何启	何福堂	父母
劫夫	黄永胜	好友
黄宗江	黄宗洛	兄弟姐妹
侯喜瑞	萧长华	师生
韩雨芹	张默	情侣
曹颖	王梓涵	父母
安乐公主	武延秀	夫妻
方中信	莫可欣	夫妻
郑克塽	郑成功	祖孙
杨子烈	张湘楚	父母
黄宗英	黄宗江	兄弟姐妹
俞灏明	刘惜君	情侣
沮渠蒙逊	沮渠兴	父母
诺维斯基	杰西卡·奥尔森	夫妻
梁欢	英达	夫妻
张世麟	任翠卿	夫妻
薛明	贺龙	夫妻
贾珍	贾惜春	兄弟姐妹
郭英丽	赵贞玉	同门
杨虎城	杨拯民	父母
松平健太	水谷隼	合作
杜甫	杜审言	祖孙
李泉	柯蓝	情侣
叶霞翟	胡宗南	夫妻
丁子高	杨千嬅	夫妻
李登辉	曾文惠	夫妻
胡瓜	李进良	父母
郑进一	贺一航	合作
赵都生	耿永清	师生
陈凯歌	陈红	夫妻
陈青远	陈丽君	父母
白雪仙	邹洁云	合作
李淳风	唐太宗	上下级
张嘉译	李念	合作
林珊珊	狄龙	亲戚
常东升	常达为	祖孙
易小准	彭壮壮	亲戚
王天伦	王天平	兄弟姐妹
谢才萍	罗璇	情侣
北岛康介	荻原舞	情侣
阿奴	白苗前族长	父母
张兰	徐熙媛	父母
高胜泉	文岚吉	师生
鲁尼	约翰·鲁尼	兄弟姐妹
孙休	孙权	父母
吴镇宇	黄秋生	好友
李彧	陈燕琳	夫妻
罗小奎	罗文奎	父母
周印金	杨海荃	师生
梅格·瑞恩	杰克·哈里	父母
夏美珍	张君秋	师生
郑汛	黄欣彤	合作
傅小石	傅抱石	父母
撒贝宁	撒贝娜	兄弟姐妹
孔继宁	孔从洲	祖孙
夏雨	袁泉	夫妻
吕志武	吕粟粟	兄弟姐妹
包小松	包小柏	兄弟姐妹
刘金定	高琼	夫妻
毛泽东	毛岸英	父母
常香玉	常老大	父母
麻生太郎	麻生太吉	祖孙
程昱	曹操	上下级
林忆莲	李喜儿	父母
刘半农	朱惠	夫妻
罗恩·阿泰斯特	高新新	情侣
赵培鑫	裘盛戎	合作
爱德华一世	亨利三世	父母
Ella	陈楚河	情侣
于俊波	周德山	合作
黄胜	严茜子	夫妻
曾昭娟	金艳荣	师生
贾探春	贾政	父母
李赛凤	罗启仁	夫妻
林庚	林宰平	父母
傅声	张展鹏	兄弟姐妹
张慕童	张智霖	父母
丁慧	郁建秀	父母
顾毓琇	朱镕基	师生
柳德米拉	普京	夫妻
刘宝瑞	殷文硕	师生
盛爱颐	宋子文	情侣
海瑞	谢氏	父母
张荣时	张宇时	兄弟姐妹
朱颖文	徐仁惠	师生
甄英莲	甄士隐	父母
孙艺洲	曹晓雯	夫妻
傅圆天	易心莹	师生
全公主	孙和	兄弟姐妹
成方圆	王刚	夫妻
杨载福	曾国藩	上下级
龙云	李培莲	夫妻
甄英莲	薛蟠	夫妻
彭清一	翟杰	师生
郭德纲	徐德亮	合作
安倍昭惠	安倍晋三	夫妻
王君安	李敏	合作
吴碧波	杨春花	师生
雪村	俞晴	夫妻
王映霞	郁达夫	夫妻
林月如	李逍遥	夫妻
罗素	约翰·康拉德·罗素	父母
王美华	曾志伟	夫妻
蒋纬国	石静宜	夫妻
李显龙	吴作栋	情侣
张舒涵	陈田	祖孙
长孙皇后	李泰	父母
李世济	唐在炘	夫妻
梁司渝	梁锦松	父母
郭台铭	郭守正	父母
栗桂莲	牛桂英	师生
孙斌武	孙书筠	兄弟姐妹
雷炳侠	干露露	父母
肯尼迪	杰奎琳·李·布维尔	夫妻
朱孝天	吴建豪	合作
董必武	黄俊贞	夫妻
孙奋	孙权	父母
法比奥·达席尔瓦	拉斐尔·达席尔瓦	兄弟姐妹
常宝霖	常连安	父母
陈翰笙	顾淑型	夫妻
柏拉图	亚里士多德	师生
林敏俐	刘倩婷	兄弟姐妹
王刚	王静	兄弟姐妹
刘询	史良娣	父母
李鸣岩	沈文莉	师生
唐老鸭	麦克法尔	亲戚
周祖谟	余淑宜	夫妻
梁从诫	梁再冰	兄弟姐妹
贾后	郭槐	父母
彭壮壮	仲琦	夫妻
苏芮	阿文	夫妻
王元龙	王次龙	兄弟姐妹
董仲舒	汉武帝	上下级
袁茵	侯耀文	夫妻
邢衍安	顾玉标	师生
李书福	李艺	父母
王学义	赵世忠	合作
刘伶	阮籍	好友
蔡和森	蔡博	父母
彭长健	文强	上下级
梁启超	梁再冰	祖孙
李焕之	李群	夫妻
洪文安	陈冠希	情侣
光武帝	阴丽华	夫妻
袁绍	袁逢	父母
李敖	王尚勤	夫妻
刘畊宏	王婉霏	夫妻
江璐	李维嘉	情侣
王夫人	贾政	夫妻
俞振庭	俞菊笙	父母
赵学义	于会江	师生
王明明	蒋兆和	师生
钱三强	钱学森	合作
贾谊	吴公	师生
奚啸伯	余叔岩	师生
薄谷开来	薄瓜瓜	父母
苏少舫	苏兰舫	父母
邓肖禹	邓碧珊	祖孙
林育英	林彪	兄弟姐妹
唐嘉盛	唐英年	父母
陈水扁	陈致中	父母
赵学义	郑菲	师生
钱浩梁	曲素英	夫妻
李嘉诚	庄碧琴	父母
杨之光	鸥洋	夫妻
陈金莲	金艳芳	合作
陆杏林	陈德霖	同门
成龙	元华	同门
蔡加赞	蔡志明	父母
林青霞	邢嘉倩	父母
俞扬和	蒋经国	父母
段正淳	甘宝宝	情侣
蔡和森	蔡畅	兄弟姐妹
孙双玉	孙六	父母
姜妙香	江世玉	师生
宋濂	孙慎	祖孙
陈再道	刘伯承	合作
佟麟阁	彭静智	夫妻
霍元甲	王五	好友
徐志摩	张幼仪	夫妻
朝美穗香	志村健	情侣
许海峰	王义夫	合作
莫叶	莫人英	父母
周佳纳	基努·里维斯	情侣
傅雷	朱梅馥	夫妻
萧纶	萧坚	父母
黄磊	孙莉	夫妻
何鸿燊	何猷龙	父母
谭晶	谭新民	父母
张学良	赵一荻	夫妻
陈之佛	陈家墀	父母
马三立	周德山	师生
陈独秀	陈松年	父母
羽根直树	羽根泰正	父母
周吕鑫	吴胜保	师生
蔡万春	蔡辰鸿	父母
王佩英	张以成	夫妻
庄希泉	余佩皋	夫妻
张春秋	梅兰芳	师生
王莉	赵学义	师生
达尔文	威廉	父母
常香玉	陈宪章	夫妻
陈乔年	陈鹤年	兄弟姐妹
黎志康	黎洪模	父母
沈殿霞	郑欣宜	父母
蔡协民	曾志	夫妻
刘觉民	梁启超	师生
买宝瑶	买红妹	父母
花淑兰	赵俊芝	师生
包小柏	包伟铭	兄弟姐妹
周朴园	周萍	父母
金孝渊	崔秀英	合作
杨铁虎	杨盛春	父母
袁世海	王连平	师生
罗巧福	戴凤玲	师生
张充和	沈从文	兄弟姐妹
傅子恩	傅彪	父母
何鸿燊	何超英	父母
张庆林	王卫红	合作
司马衍	庾文君	父母
梁思懿	梁启超	父母
郭德纲	李菁	合作
胡兵	林嘉绮	好友
俞珊	俞启威	兄弟姐妹
华天	华龙毅	祖孙
周采茨	裘丽琳	父母
林黛玉	贾母	祖孙
郑则仕	赵崇基	好友
何桂山	裘桂仙	师生
霍英东	霍震霆	父母
寇春华	孙盛武	师生
廖桂永	沈蔓蓉	夫妻
埃斯特拉达	吉亚戈梅兹	情侣
小S	徐熙媛	兄弟姐妹
埃文·约翰逊	Buss	上下级
王菁	何炅	夫妻
刘翔	史冬鹏	合作
孔令文	小林清芽	夫妻
陈乔恩	明道	好友
范曾	林岫	夫妻
刘晓东	喻红	夫妻
岛左近	石田三成	上下级
陈志朋	苏有朋	合作
慕容皝	慕容恪	父母
秦琼	长孙无忌	合作
诺维茨基	杰西卡·奥尔森	夫妻
端木蕻良	钟耀群	夫妻
夏侯楙	夏侯子臧	兄弟姐妹
钱思亮	张婉度	夫妻
侯佩岑	侯世宏	父母
张爱玲	张子静	兄弟姐妹
蒋英	钱学森	夫妻
张一白	陆川	好友
吴卓林	成龙	父母
陈发科	陈照奎	父母
毛泽东	毛泽覃	兄弟姐妹
周汝昌	周伦玲	父母
袁日初	袁振威	兄弟姐妹
白鸟库吉	和田清	师生
杨子烈	张海威	父母
周星驰	成龙	好友
贝娜齐尔·布托	佐勒菲卡尔·阿里·布托	父母
毛泽民	毛泽东	兄弟姐妹
李静	戴军	合作
李砚秀	李砚萍	兄弟姐妹
方声洞	方振隆	祖孙
袁世凯	袁仲祯	父母
薄一波	薄瓜瓜	祖孙
朱孝天	林熙蕾	情侣
吴安然	吴阶平	兄弟姐妹
张会	王濛	合作
马鸿宾	马福寿	亲戚
吴雁泽	姜家祥	师生
马葭	景岗山	夫妻
张会	刘秋宏	合作
程砚秋	果素瑛	夫妻
曹洪	曹震	父母
宋小宝	赵本山	师生
马富禄	马连良	合作
索尼娅·甘地	女	父母
罗伯特·德尼罗	Niro	父母
刘永言	刘永好	兄弟姐妹
猪八戒	孙悟空	同门
王皃姁	王娡	兄弟姐妹
杨班侯	张信义	师生
许广平	周建人	兄弟姐妹
王仕鹏	孙悦	合作
邓颖超	孙维世	父母
刘谦	李蕴	情侣
金筱邦	支维永	合作
洪学智	张爱萍	合作
常俊丽	贾廷聚	合作
汉景帝刘启	汉文帝	父母
马佩璋	马维琪	父母
冯德伦	莫文蔚	情侣
最上义光	伊达政宗	亲戚
郭子仪	郭晞	父母
韩凤英	厉彦芝	夫妻
徐天红	尹桂芳	合作
李小龙	何爱榆	父母
陈慧珊	海俊杰	兄弟姐妹
陆昌立	沈星培	师生
张静江	朱逸民	夫妻
金正哲	张成泽	亲戚
侯耀华	常宝华	师生
孟鸿茂	孟福保	父母
连惠心	连胜文	兄弟姐妹
莫声谷	殷梨亭	同门
彭家元	彭传梁	父母
高胜泉	马岚波	师生
钟腾福	张洁雯	夫妻
司马懿	司马朗	兄弟姐妹
郭羡妮	张舒雅	同门
黎瑞恩	曾智明	夫妻
孔雀屏	林超群	师生
朱木炎	杨淑君	情侣
蒋万安	蒋惠兰	兄弟姐妹
史冬鹏	乔艳蕊	夫妻
孔子	言偃	师生
刘政会	李世民	上下级
丁至云	杨宝森	合作
李嘉诚	李云经	父母
猪哥亮	张菲	合作
方文山	周杰伦	好友
袁雪芬	王杏花	合作
荣剑尘	谢舒扬	师生
贾母	王夫人	父母
马伊俐	文爱马	父母
粟裕	陈赓	合作
罗大佑	张震岳	合作
王予柔	易建联	好友
雪梨	徐少强	夫妻
梁实秋	程季淑	夫妻
龚睿娜	周蜜	合作
杜月笙	杜维善	父母
英若诚	蔡儒楷	祖孙
罗振玉	罗福颐	父母
程廷华	孙禄堂	师生
白全福	常宝霆	合作
小岚云	钟少亭	亲戚
潘晓婷	林正晃	师生
马克·麦兹温斯基	切尔西·克林顿	情侣
徐威	张怡宁	夫妻
刘山丽	华世香	师生
姚弋仲	姚襄	父母
柳真	基泰英	情侣
王昆仑	曹孟君	夫妻
赵本山	赵玉芳	父母
克鲁兹·贝克汉姆	大卫·贝克汉姆	父母
图坦卡蒙	阿肯那顿	父母
王重阳	王处一	师生
胡德平	胡耀邦	父母
洪金宝	洪天照	父母
邓莲如	唐明治	夫妻
董圆圆	梅葆玖	师生
周侗	岳飞	师生
周信芳	周慰堂	父母
孙渠	侯光炯	好友
孟俊泉	王晓临	夫妻
唐玉成	冯垛	师生
宇野宗佑	竹下登	情侣
魏延	刘备	上下级
杰米·雷德克纳普	哈里·雷德克纳普	父母
姜妙香	陆杏林	师生
张辽	曹操	上下级
长孙皇后	城阳公主	父母
杨扬	张震	夫妻
霍启山	霍启仁	兄弟姐妹
曹峻	曹玹	兄弟姐妹
勒布朗-詹姆斯	安东尼	合作
范荣康	梁左	父母
李秉宪	宋承宪	好友
林凤娇	房祖名	父母
江泽民	江上青	父母
李学清	李学涤	兄弟姐妹
钱妙花	钱妙英	兄弟姐妹
王政君	王凤	兄弟姐妹
成昆	阳夫人	情侣
于素秋	麦炳荣	夫妻
周扬	周艾若	父母
佟晨洁	谢晖	夫妻
胡蝶	潘有声	夫妻
张振圻	王文玉	师生
张充和	傅汉思	夫妻
莱因哈特·海德里希	希特勒	上下级
梁天	孙凤英	夫妻
樊小纯	郎咸平	情侣
谢婷婷	狄波拉	父母
王珞丹	李光洁	情侣
尼克松	弗朗西斯·安东尼·尼克松	父母
黄霑	黄宇诗	父母
陈金莲	徐玉兰	合作
夏姬	夏御叔	夫妻
傅斯年	俞大维	亲戚
张抗抗	姜戎	夫妻
李民斌	潘金翠	父母
王治郅	王维君	父母
朱俊好	宋长荣	师生
浦通修	浦洁修	兄弟姐妹
东山纪之	木村佳乃	夫妻
杨振基	裴秀荣	夫妻
谭咏麟	谭晓风	父母
叶玉卿	叶志铭	兄弟姐妹
成钧	余秋里	合作
陈国熹	叶童	夫妻
郭荣启	张宝如	师生
刘翔	刘学根	父母
冯亦代	楼文光	父母
彭顺	李心洁	夫妻
齐白石	齐良末	父母
侯君集	房玄龄	合作
鲜灵霞	王媛	师生
邱士楷	林志玲	情侣
申世京	钟铉	情侣
侯少奎	侯永奎	父母
常佩业	王福田	师生
蒋才如	刘光宇	师生
张澜	张惠延	父母
贾赦	贾琮	父母
荀慧生	荀令香	父母
高盛麟	茹莱卿	师生
郭晶晶	霍震霆	父母
潘长江	潘阳	父母
王大珩	王应伟	父母
高秀敏	赵本山	合作
张謇	张孝若	父母
吴大揆	吴公仪	父母
穆宇	张学津	师生
贾母	林黛玉	祖孙
马鼎盛	红线女	父母
拿破仑	莱蒂西亚·拉莫利诺	父母
邓婕	张国立	夫妻
孙国豪	邵乔茵	父母
张庭	林瑞阳	夫妻
舍甫琴科	克里斯蒂娜	夫妻
杨紫琼	杨南日	兄弟姐妹
洪学智	洪虎	父母
李德伦	吴祖强	合作
陈镜开	陈竞奎	父母
杨荣环	李经文	师生
汪桂芬	谭鑫培	合作
白静	周成海	夫妻
苏少卿	苏娥	父母
唐代宗	李逾	父母
周蜜	周蜜	合作
马英九	马冰如	兄弟姐妹
曾志	蔡协民	夫妻
阎世善	谢锐青	师生
黄药师	曲灵风	师生
元昭皇后	李怡	夫妻
黄秋生	刘青云	好友
陈士榘	李峥	夫妻
贺聪	葛优	夫妻
戴碧芝	张柏芝	兄弟姐妹
解忧公主	刘戊	祖孙
车晓	李兆会	夫妻
马彦祥	沉樱	夫妻
马时亨	曾启荣	亲戚
